date,buy/sell oil,buy/sell futures,storage, cash ,futures position,debt_over_oil,pnl,oil_spot,oil_futures
20050103,5000,2500,495000,210598.89,2500,0,0,42.13,40.892
20050104,5050,2475,490050,430888.16,4975,0,2970,43.91,42.08
20050105,5099,2451,485149,641307.15,7426,0,-2218.85,43.39,41.634
20050106,5149,2426,480298,872684.51,9852,0,10366.696,45.56,43.03
20050107,5197,2402,475495,1089710.99,12254,0,-1192.092,45.43,42.909
20050110,5245,2378,470740,1303551.40,14632,0,-1740.068,45.33,42.767
20050111,5293,2354,466033,1522000.83,16986,0,3379.992,45.68,42.998
20050112,5340,2330,461373,1746428.31,19316,0,8272.182,46.37,43.485
20050113,5386,2307,456759,1992557.27,21623,0,24338.16,48.05,44.745
20050114,5432,2284,452191,2223827.69,23907,0,10162.81,48.38,45.215
20050118,5478,2261,447669,2451167.61,26168,0,8439.171,48.38,45.568
20050119,5523,2239,443192,2652026.44,28407,0,-12168.12,47.55,45.103
20050120,5568,2216,438760,2850549.37,30623,0,-9544.752,46.91,44.767
20050121,5612,2194,434372,3097336.81,32817,0,34757.105,48.28,45.902
20050124,5656,2172,430028,3321035.37,34989,0,12339.192,48.61,46.278
20050125,5700,2150,425728,3561973.59,37139,0,28131.156,49.44,47.082
20050126,5743,2129,421471,3755009.72,39268,0,-14855.6,48.78,46.682
20050127,5785,2108,417256,3960296.91,41376,0,-824.628,48.84,46.661
20050128,5827,2087,413083,4113962.10,43463,0,-43486.176,47.18,45.61
20050131,5869,2066,408952,4341043.58,45529,0,27685.931,48.2,46.247
20050201,5910,2045,404862,4524230.33,47574,0,-9834.264,47.12,46.031
20050202,5951,2025,400813,4695420.59,49599,0,-18173.268,46.69,45.649
20050203,5992,2004,396805,4875623.14,51603,0,-6299.073,46.45,45.522
20050204,6032,1984,392837,5064270.82,53587,0,3870.225,46.48,45.597
20050207,6072,1964,388909,5209106.94,55551,0,-33384.701,45.28,44.974
20050208,6111,1945,385020,5390317.88,57496,0,4277.427,45.4,45.051
20050209,6150,1925,381170,5562679.51,59421,0,-3047.288,45.46,44.998
20050210,6188,1906,377358,5800264.29,61327,0,57638.37,47.1,45.968
20050211,6226,1887,373584,5972718.15,63214,0,-5948.719,47.16,45.871
20050214,6264,1868,369848,6163600.49,65082,0,13211.726,47.44,46.08
20050215,6302,1849,366150,6327559.43,66931,0,-11259.186,47.26,45.907
20050216,6338,1831,362488,6564441.99,68762,0,59434.728,48.33,46.795
20050217,6375,1813,358863,6725911.64,70575,0,-11345.73,47.54,46.63
20050218,6411,1795,355274,6947008.94,72370,0,47073.525,48.35,47.297
20050222,6447,1777,351721,7258220.38,74147,0,128963.34,51.15,49.079
20050223,6483,1759,348204,7439902.55,75906,0,3114.174,50.62,49.121
20050224,6518,1741,344722,7652503.46,77647,0,35372.196,50.74,49.587
20050225,6553,1724,341275,7845357.01,79371,0,16694.105,50.94,49.802
20050228,6587,1707,337862,8068282.09,81078,0,45717.696,51.75,50.378
20050301,6621,1690,334483,8261916.22,82768,0,18404.706,51.68,50.605
20050302,6655,1673,331138,8521595.51,84441,0,81609.248,53.05,51.591
20050303,6689,1656,327827,8729665.49,86097,0,30060.996,53.57,51.947
20050304,6722,1639,324549,8919354.37,87736,0,12742.356,53.78,52.095
20050307,6755,1623,321304,9136485.17,89359,0,41586.864,53.89,52.569
20050308,6787,1607,318091,9372352.16,90966,0,59781.171,54.59,53.238
20050309,6819,1591,314910,9570479.09,92557,0,23196.33,54.77,53.493
20050310,6851,1575,311761,9685932.35,94132,0,-53868.174,53.54,52.911
20050311,6882,1559,308643,9924529.72,95691,0,68151.568,54.43,53.635
20050314,6914,1543,305557,10166881.89,97234,0,72055.323,54.94,54.388
20050315,6944,1528,302501,10364861.99,98762,0,28975.732,55.05,54.686
20050316,6975,1513,299476,10681719.10,100275,0,145278.902,56.46,56.157
20050317,7005,1498,296481,10899681.49,101773,0,48232.275,56.4,56.638
20050318,7035,1483,293516,11153157.24,103256,0,84471.59,56.72,57.468
20050321,7065,1468,290581,11356532.87,104724,0,36346.112,56.62,57.82
20050322,7094,1453,287675,11461996.42,106177,0,-58226.544,56.03,57.264
20050323,7123,1439,284798,11441775.60,107616,0,-165954.651,50.35,55.701
20050324,7152,1424,281950,11618503.12,109040,0,30347.712,51.09,55.983
20050329,7180,1410,279130,11615087.07,110450,0,-157235.68,54.23,54.541
20050330,7209,1396,276339,11803885.71,111846,0,37221.65,53.99,54.878
20050331,7237,1382,273576,12143749.20,113228,0,185888.052,55.4,56.54
20050401,7264,1368,270840,12518995.65,114596,0,217624.216,57.27,58.462
20050404,7292,1354,268132,12717084.73,115950,0,42744.308,57.01,58.835
20050405,7319,1341,265451,12765110.98,117291,0,-103195.5,56.04,57.945
20050406,7345,1328,262796,12873089.27,118619,0,-41286.432,55.85,57.593
20050407,7372,1314,260168,12859468.91,119933,0,-156814.318,54.11,56.271
20050408,7398,1301,257566,12907811.25,121234,0,-91388.946,53.32,55.509
20050411,7424,1288,254990,13090081.69,122522,0,42916.836,53.71,55.863
20050412,7450,1275,252440,13072022.40,123797,0,-151314.67,51.86,54.628
20050413,7476,1262,249916,13054452.04,125059,0,-145337.678,50.22,53.454
20050414,7501,1250,247417,13213876.16,126309,0,30639.455,51.13,53.699
20050415,7526,1237,244943,13272111.02,127546,0,-67701.624,50.49,53.163
20050418,7551,1225,242494,13306576.86,128771,0,-89919.93,50.37,52.458
20050419,7575,1213,240069,13674054.52,129984,0,239642.831,52.29,54.319
20050420,7599,1201,237668,13930227.77,131185,0,129204.096,52.44,55.313
20050421,7623,1189,235291,14140789.75,132374,0,85401.435,52.2,55.964
20050422,7647,1177,232938,14395490.12,133551,0,125622.926,54.39,56.913
20050425,7671,1165,230609,14479838.96,134716,0,-41534.361,53.57,56.602
20050426,7694,1153,228303,14578333.25,135869,0,-27616.78,54.2,56.397
20050427,7717,1142,226020,14460610.14,137011,0,-236683.798,51.61,54.655
20050428,7740,1130,223760,14580791.47,138141,0,2055.165,51.77,54.67
20050429,7762,1119,221522,14511546.02,139260,0,-181655.415,49.72,53.355
20050502,7785,1108,219307,14749127.57,140368,0,123662.88,50.92,54.243
20050503,7807,1097,217114,14700496.77,141465,0,-158335.104,49.5,53.115
20050504,7829,1086,214943,14875974.24,142551,0,65498.295,50.13,53.578
20050505,7851,1075,212794,15021721.70,143626,0,35352.648,50.83,53.826
20050506,7872,1064,210666,15113671.75,144690,0,-17665.998,50.96,53.703
20050509,7893,1054,208559,15222888.17,145744,0,-1591.59,52.03,53.692
20050510,7914,1043,206473,15370735.07,146787,0,38039.184,52.07,53.953
20050511,7935,1033,204408,15323017.81,147820,0,-153098.841,50.45,52.91
20050512,7956,1022,202364,15267039.35,148842,0,-156393.56,48.54,51.852
20050513,7976,1012,200340,15382370.92,149854,0,15628.41,48.67,51.957
20050516,7997,1002,198337,15431489.65,150856,0,-49451.82,48.61,51.627
20050517,8017,992,196354,15573554.17,151848,0,43748.24,48.97,51.917
20050518,8036,982,194390,15556573.03,152830,0,-111000.888,47.25,51.186
20050519,8056,972,192446,15629748.65,153802,0,-19256.58,46.92,51.06
20050520,8076,962,190522,15767465.72,154764,0,46448.204,46.8,51.362
20050523,8095,953,188617,15902781.32,155717,0,41476.752,48.61,51.63
20050524,8114,943,186731,16028751.48,156660,0,31610.551,49.37,51.833
20050525,8133,934,184864,16251415.40,157594,0,126581.28,50.79,52.641
20050526,8151,925,183015,16380576.08,158519,0,33567.522,51.01,52.854
20050527,8170,915,181185,16531418.45,159434,0,54689.055,51.84,53.199
20050531,8188,906,179373,16664353.38,160340,0,37466.99,51.97,53.434
20050601,8206,897,177579,17175206.60,161237,0,411592.78,54.6,56.001
20050602,8224,888,175803,17225205.26,162125,0,-46597.493,53.63,55.712
20050603,8242,879,174045,17549627.42,163004,0,226326.5,55.03,57.108
20050606,8260,870,172305,17687711.06,163874,0,41892.028,54.49,57.365
20050607,8277,862,170582,17712083.57,164736,0,-69646.45,53.76,56.94
20050608,8294,853,168876,17657812.72,165589,0,-145297.152,52.54,56.058
20050609,8311,845,167187,17982539.00,166434,0,231659.011,54.28,57.457
20050610,8328,836,165515,17951975.95,167270,0,-121496.82,53.54,56.727
20050613,8345,828,163860,18356895.69,168098,0,311456.74,55.62,58.589
20050614,8361,820,162221,18362083.06,168918,0,-86402.372,55,58.075
20050615,8378,811,160599,18462937.26,169729,0,9290.49,55.56,58.13
20050616,8394,803,158993,18691889.96,170532,0,136631.845,56.58,58.935
20050617,8410,795,157403,19028825.12,171327,0,242496.504,58.47,60.357
20050620,8426,787,155829,19234775.96,172114,0,111019.896,59.36,61.005
20050621,8442,779,154271,19199660.43,172893,0,-128397.044,58.9,60.259
20050622,8457,772,152728,19165937.58,173665,0,-124482.96,57.84,59.539
20050623,8473,764,151201,19453944.40,174429,0,196067.785,59.22,60.668
20050624,8488,756,149689,19626588.35,175185,0,80935.056,59.64,61.132
20050627,8503,749,148192,19880619.58,175934,0,161870.94,60.53,62.056
20050628,8518,741,146710,19670041.19,176675,0,-298384.064,58.19,60.36
20050629,8533,734,145243,19629079.35,177409,0,-126499.3,57.25,59.644
20050630,8548,726,143791,19625543.87,178135,0,-87107.819,56.49,59.153
20050701,8562,719,142353,20009416.26,178854,0,297841.72,58.75,60.825
20050705,8576,712,140929,20351791.09,179566,0,255940.074,59.59,62.256
20050706,8591,705,139520,20652705.66,180271,0,212965.276,61.28,63.442
20050707,8605,698,138125,20657932.30,180969,0,-81121.95,60.73,62.992
20050708,8619,691,136744,20592322.47,181660,0,-151109.115,60.73,62.157
20050711,8633,684,135377,20576409.69,182344,0,-98096.4,58.93,61.617
20050712,8646,677,134023,20874450.44,183021,0,216624.672,58.93,62.805
20050713,8660,670,132683,20847249.42,183691,0,-109263.537,60.01,62.208
20050714,8673,664,131356,20547194.37,184355,0,-378403.46,57.8,60.148
20050715,8686,657,130042,20664047.48,185012,0,38898.905,58.09,60.359
20050718,8700,650,128742,20638625.58,185662,0,-101571.588,57.32,59.81
20050719,8713,644,127455,20759509.88,186306,0,45301.528,57.46,60.054
20050720,8725,638,126180,20752799.12,186944,0,-80670.498,56.72,59.621
20050721,8738,631,124918,20685183.25,187575,0,-139273.28,55.48,58.876
20050722,8751,625,123669,20989042.68,188200,0,231467.55,56.65,60.11
20050725,8763,619,122432,21143347.66,188819,0,83372.6,56,60.553
20050726,8776,612,121208,21290743.06,189431,0,73261.772,59.2,60.941
20050727,8788,606,119996,21419951.23,190037,0,55882.145,59.11,61.236
20050728,8800,600,118796,21659856.56,190637,0,166282.375,59.94,62.111
20050729,8812,594,117608,21869452.03,191231,0,135924.181,60.57,62.824
20050801,8824,588,116432,22150118.60,191819,0,206529.48,61.57,63.904
20050802,8836,582,115268,22284143.12,192401,0,60231.166,61.89,63.989
20050803,8847,577,114115,22193692.77,192978,0,-162386.444,60.86,63.145
20050804,8859,571,112974,22296940.18,193549,0,31455.414,61.38,63.308
20050805,8870,565,111844,22483890.74,194114,0,114774.557,62.31,63.901
20050808,8882,559,110726,22678283.47,194673,0,121127.136,63.94,64.525
20050809,8893,554,109619,22654703.39,195227,0,-95195.097,63.07,64.036
20050810,8904,548,108523,22991184.70,195775,0,263556.45,64.9,65.386
20050811,8915,543,107438,23096310.53,196318,0,31911.325,65.8,65.549
20050812,8926,537,106364,23167396.14,196855,0,-2552.134,66.86,65.536
20050815,8936,532,105300,23364352.43,197387,0,124609.215,66.27,66.169
20050816,8947,527,104247,23462038.81,197914,0,26252.471,66.08,66.302
20050817,8958,521,103205,23086478.23,198435,0,-443327.36,63.25,64.062
20050818,8968,516,102173,23141300.31,198951,0,-12302.97,63.27,64
20050819,8978,511,101151,23466370.47,199462,0,256447.839,65.35,65.289
20050822,8988,506,100139,23551420.91,199968,0,16954.27,65.45,65.374
20050823,8999,501,99138,23737894.78,200469,0,119180.928,65.36,65.97
20050824,9009,496,98147,24154257.58,200965,0,348014.184,67.07,67.706
20050825,9019,491,97166,24280866.50,201456,0,58681.78,67.29,67.998
20050826,9028,486,96194,24114389.40,201942,0,-232681.68,66.13,66.843
20050829,9038,481,95232,24274245.97,202423,0,93297.204,67.2,67.305
20050830,9048,476,94280,24525216.34,202899,0,182585.546,69.81,68.207
20050831,9057,472,93337,24556259.60,203371,0,-35913.123,68.94,68.03
20050901,9067,467,92404,24756638.32,203838,0,133614.747,69.47,68.687
20050902,9076,462,91480,24593962.39,204300,0,-227075.532,67.57,67.573
20050906,9085,458,90565,24542064.26,204758,0,-114203.7,65.96,67.014
20050907,9094,453,89659,24363379.35,205211,0,-238952.586,64.37,65.847
20050908,9103,449,88762,24479799.34,205660,0,56638.236,64.49,66.123
20050909,9112,444,87874,24426972.82,206104,0,-111673.38,64.08,65.58
20050912,9121,440,86995,24332896.03,206544,0,-151692.544,63.34,64.844
20050913,9130,435,86125,24326944.95,206979,0,-62789.376,63.11,64.54
20050914,9139,431,85264,24695801.82,207410,0,310882.458,65.09,66.042
20050915,9147,427,84411,24726861.50,207837,0,-26133.66,64.75,65.916
20050916,9156,422,83567,24468787.70,208259,0,-313210.359,63,64.409
20050919,9164,418,82731,25059587.51,208677,0,532518.263,67.39,66.966
20050920,9173,414,81904,24964016.57,209091,0,-152334.21,66.23,66.236
20050921,9181,410,81085,25087577.42,209501,0,66909.12,66.75,66.556
20050922,9189,406,80274,25199825.69,209907,0,56355.769,66.46,66.825
20050923,9197,402,79471,24956055.33,210309,0,-297438.219,64.34,65.408
20050926,9205,398,78676,25217309.55,210707,0,206944.056,65.82,66.392
20050927,9213,394,77889,25211518.17,211101,0,-58997.96,65.06,66.112
20050928,9221,390,77110,25390180.53,211491,0,124971.792,66.35,66.704
20050929,9229,386,76339,25324624.64,211877,0,-119069.433,66.79,66.141
20050930,9237,382,75576,25434597.71,212259,0,57418.667,66.24,66.412
20051003,9244,378,74820,25309728.17,212637,0,-176387.229,65.47,65.581
20051004,9252,374,74072,25107137.99,213011,0,-252400.119,63.9,64.394
20051005,9259,371,73331,25017417.99,213382,0,-138244.139,62.79,63.745
20051006,9267,367,72598,24702062.24,213749,0,-362322.636,61.36,62.047
20051007,9274,363,71872,24891493.45,214112,0,142570.583,61.84,62.714
20051011,9281,360,71153,25215784.02,214472,0,276632.704,63.53,64.006
20051012,9288,356,70441,25290895.72,214828,0,27452.416,64.12,64.134
20051013,9296,352,69737,25180276.89,215180,0,-157039.268,63.08,63.403
20051014,9303,349,69040,24976970.30,215529,0,-248963.26,62.63,62.246
20051017,9310,345,68350,25167123.84,215874,0,143757.843,64.36,62.913
20051018,9316,342,67666,24871274.61,216216,0,-341080.92,63.2,61.333
20051019,9323,339,66989,24728695.00,216555,0,-186810.624,62.41,60.469
20051020,9330,335,66319,24591596.21,216890,0,-179957.205,61.03,59.638
20051021,9337,332,65656,24891347.32,217222,0,257231.54,61.18,60.824
20051024,9343,329,64999,24910893.39,217551,0,-22591.088,61.12,60.72
20051025,9350,325,64349,25428765.87,217876,0,474913.833,63.04,62.903
20051026,9357,322,63706,25234270.64,218198,0,-235523.956,60.66,61.822
20051027,9363,319,63069,25305523.35,218517,0,30329.522,61.09,61.961
20051028,9369,316,62438,25322568.01,218833,0,-23599.836,61.22,61.853
20051031,9376,312,61814,25193373.11,219145,0,-168501.41,59.76,61.083
20051101,9382,309,61196,25291316.41,219454,0,58950.005,59.85,61.352
20051102,9388,306,60584,25371593.56,219760,0,41696.26,59.75,61.542
20051103,9394,303,59978,25792335.98,220063,0,381283.6,61.78,63.277
20051104,9400,300,59378,25604733.33,220363,0,-226004.701,60.58,62.25
20051107,9406,297,58784,25463163.01,220660,0,-178934.756,59.47,61.438
20051108,9412,294,58196,25537812.68,220954,0,37512.2,59.71,61.608
20051109,9418,291,57614,25381030.34,221245,0,-193113.796,58.93,60.734
20051110,9424,288,57038,25242446.42,221533,0,-173898.57,57.8,59.948
20051114,9430,285,56468,25213096.04,221818,0,-64244.57,57.69,59.658
20051115,9435,283,55903,25124189.43,222101,0,-123108.99,56.98,59.103
20051116,9441,280,55344,25310685.10,222381,0,152139.185,57.88,59.788
20051117,9447,277,54791,25195752.04,222658,0,-148105.746,56.34,59.122
20051118,9452,274,54243,25301220.39,222932,0,72586.508,56.34,59.448
20051121,9458,271,53701,25463316.38,223203,0,129077.628,57.2,60.027
20051122,9463,269,53164,25639577.49,223472,0,142849.92,58.44,60.667
20051123,9468,266,52632,25615065.56,223738,0,-57655.776,58.46,60.409
20051128,9474,263,52106,25437412.06,224001,0,-209866.244,57.36,59.471
20051129,9479,261,51585,25372555.42,224262,0,-96320.43,56.5,59.041
20051130,9484,258,51069,25615185.15,224520,0,211030.542,57.32,59.982
20051201,9489,256,50558,25894525.76,224776,0,247421.04,58.47,61.084
20051202,9494,253,50052,26141716.02,225029,0,215110.632,59.32,62.041
20051205,9499,251,49551,26352712.44,225280,0,178898.055,59.91,62.836
20051206,9504,248,49055,26370801.03,225528,0,-13742.08,59.94,62.775
20051207,9509,246,48564,26346495.23,225774,0,-55479.888,59.21,62.529
20051208,9514,243,48078,26698900.79,226017,0,320824.854,60.66,63.95
20051209,9519,241,47597,26498154.30,226258,0,-231441.408,59.39,62.926
20051212,9524,238,47121,26860008.23,226496,0,330562.938,61.3,64.387
20051213,9529,236,46650,26888336.75,226732,0,-2717.952,61.37,64.375
20051214,9533,234,46183,26860853.87,226966,0,-58043.392,60.85,64.119
20051215,9538,231,45721,26798789.53,227197,0,-91921.23,59.99,63.714
20051216,9543,229,45264,26416460.40,227426,0,-410999.373,58.06,61.905
20051219,9547,227,44811,26240768.11,227653,0,-203773.696,57.34,61.009
20051220,9552,224,44363,26261550.69,227877,0,-7284.896,57.98,60.977
20051221,9556,222,43919,26360426.40,228099,0,70869.747,58.36,61.288
20051222,9561,220,43480,26337681.60,228319,0,-50409.879,58.23,61.067
20051223,9565,218,43045,26370298.10,228537,0,5251.337,58.08,61.09
20051227,9570,215,42615,26334100.93,228752,0,-63304.749,58.15,60.813
20051228,9574,213,42189,26710755.64,228965,0,349075.552,59.81,62.339
20051229,9578,211,41767,26891972.18,229176,0,153635.515,60.31,63.01
20051230,9582,209,41349,27114197.83,229385,0,194570.424,61.03,63.859
20060103,9587,207,40936,27625521.77,229592,0,483084.81,63.14,65.965
20060104,9591,205,40527,27674097.51,229797,0,20433.688,63.42,66.054
20060105,9595,203,40122,27549379.34,230000,0,-152355.411,62.79,65.391
20060106,9599,201,39721,27813994.82,230201,0,236670,64.21,66.42
20060109,9603,199,39324,27794231.65,230400,0,-47191.205,63.5,66.215
20060110,9607,197,38931,27847618.67,230597,0,26265.6,63.37,66.329
20060111,9611,195,38542,27895696.99,230792,0,20984.327,63.94,66.42
20060112,9615,193,38157,27944002.78,230985,0,21463.656,63.94,66.513
20060113,9618,191,37775,28023313.95,231176,0,52664.58,63.92,66.741
20060117,9622,189,37397,28501638.88,231365,0,451024.376,66.31,68.692
20060118,9626,187,37023,28409115.05,231552,0,-119384.34,65.74,68.176
20060119,9630,185,36653,28622276.31,231737,0,186167.808,66.83,68.98
20060120,9633,184,36286,28899920.06,231921,0,250275.96,68.35,70.06
20060123,9637,182,35923,28907141.95,232103,0,-19713.285,67.85,69.975
20060124,9641,180,35564,28754456.54,232283,0,-178951.413,66.74,69.204
20060125,9644,178,35208,28556559.17,232461,0,-223456.246,65.35,68.242
20060126,9648,176,34856,28678167.57,232637,0,96006.393,66.26,68.655
20060127,9651,175,34507,29044451.86,232812,0,340347.931,67.76,70.118
20060130,9655,173,34162,29215857.55,232985,0,145507.5,68.35,70.743
20060131,9658,171,33820,29232796.96,233156,0,-8620.445,67.92,70.706
20060201,9662,169,33482,29018408.92,233325,0,-239218.056,66.56,69.68
20060202,9665,168,33147,28691238.34,233493,0,-351154.125,64.68,68.175
20060203,9669,166,32816,28873240.16,233659,0,158074.761,65.37,68.852
20060206,9672,164,32488,28931481.97,233823,0,34581.532,65.11,69
20060207,9675,163,32163,28611276.90,233986,0,-343018.341,63.09,67.533
20060208,9678,161,31841,28461253.84,234147,0,-172447.682,62.55,66.796
20060209,9682,159,31523,28468219.04,234306,0,-15219.555,62.62,66.731
20060210,9685,158,31208,28401637.49,234464,0,-88333.362,61.84,66.354
20060213,9688,156,30896,28323833.09,234620,0,-99178.272,61.24,65.931
20060214,9691,155,30587,28101669.40,234775,0,-242831.7,59.57,64.896
20060215,9694,153,30281,27829963.01,234928,0,-291590.55,57.65,63.654
20060216,9697,152,29978,28013877.64,235080,0,163979.744,58.46,64.352
20060217,9700,150,29678,28283262.65,235230,0,249184.8,59.88,65.412
20060221,9703,149,29381,28588530.57,235379,0,284863.53,61.1,66.623
20060222,9706,147,29087,28391554.47,235526,0,-216313.301,58.01,65.704
20060223,9709,146,28796,28452480.20,235672,0,41688.102,58.32,65.881
20060224,9712,144,28508,28838281.70,235816,0,365527.272,62.51,67.432
20060227,9715,143,28223,28573339.11,235959,0,-284629.912,61,66.225
20060228,9718,141,27941,28726018.77,236100,0,133080.876,61.41,66.789
20060301,9721,140,27662,28889150.56,236240,0,143548.8,61.97,67.397
20060302,9723,139,27385,29198637.88,236379,0,289630.24,63.36,68.623
20060303,9726,137,27111,29270418.02,236516,0,52003.38,63.67,68.843
20060306,9729,136,26840,28976281.76,236652,0,-313383.7,62.4,67.518
20060307,9732,134,26572,28732415.13,236786,0,-262683.72,61.58,66.408
20060308,9734,133,26306,28464163.65,236919,0,-286511.06,60.02,65.198
20060309,9737,132,26043,28638943.51,237051,0,156603.459,60.47,65.859
20060310,9740,130,25783,28513167.08,237181,0,-143652.906,59.96,65.253
20060313,9742,129,25525,28878139.11,237310,0,346758.622,61.77,66.715
20060314,9745,128,25270,29238973.83,237438,0,342438.33,63.1,68.158
20060315,9747,127,25017,28935309.22,237565,0,-321728.49,62.17,66.803
20060316,9750,125,24767,29192502.70,237690,0,238990.39,63.57,67.809
20060317,9752,124,24519,29028568.05,237814,0,-181832.85,62.77,67.044
20060320,9755,123,24274,28664000.19,237937,0,-381691.47,60.43,65.439
20060321,9757,122,24031,28815442.20,238059,0,134434.405,60.57,66.004
20060322,9760,120,23791,28713536.87,238179,0,-118791.441,60.77,65.505
20060323,9762,119,23553,29048414.16,238298,0,317492.607,63.41,66.838
20060324,9764,118,23317,29103715.66,238416,0,37889.382,63.95,66.997
20060327,9767,117,23084,29126711.30,238533,0,5721.984,64.16,67.021
20060328,9769,116,22853,29490172.49,238649,0,345872.85,66.07,68.471
20060329,9771,115,22624,29620387.12,238764,0,112642.328,66.45,68.943
20060330,9774,113,22398,29852338.77,238877,0,214410.072,67.15,69.841
20060331,9776,112,22174,29823549.40,238989,0,-46103.261,66.65,69.648
20060403,9778,111,21952,29853655.32,239100,0,12905.406,66.75,69.702
20060404,9780,110,21732,29854831.98,239210,0,-15780.6,66.24,69.636
20060405,9783,109,21515,29986115.29,239319,0,114342.38,67.08,70.114
20060406,9785,108,21300,30105548.15,239427,0,102428.532,67.95,70.542
20060407,9787,107,21087,30104591.43,239534,0,-17717.598,67.4,70.468
20060410,9789,106,20876,30438884.79,239640,0,317382.55,68.75,71.793
20060411,9791,105,20667,30570043.29,239745,0,114308.28,68.99,72.27
20060412,9793,104,20460,30566792.72,239849,0,-19898.835,68.63,72.187
20060413,9795,103,20255,30736950.32,239952,0,153503.36,69.33,72.827
20060418,9797,102,20052,31233555.59,240054,0,479664.048,71.36,74.826
20060419,9799,101,19851,31492293.00,240155,0,241734.378,72.18,75.833
20060420,9801,100,19652,31460617.33,240255,0,-48511.31,71.96,75.631
20060421,9803,99,19455,31791207.66,240354,0,313532.775,73.83,76.936
20060424,9805,98,19260,31600950.69,240452,0,-206464.086,70.09,76.077
20060425,9807,97,19067,31667648.23,240549,0,50975.824,68.38,76.289
20060426,9809,96,18876,31494606.50,240645,0,-189312.063,71.94,75.502
20060427,9811,95,18687,31295401.11,240740,0,-215136.63,70.98,74.608
20060428,9813,94,18500,31481066.34,240834,0,169721.7,71.89,75.313
20060502,9815,93,18315,32030351.56,240927,0,532965.642,74.62,77.526
20060503,9817,92,18132,31695590.77,241019,0,-350548.785,72.29,76.071
20060504,9819,91,17951,31255258.08,241110,0,-455525.91,69.95,74.181
20060505,9820,90,17771,31329463.11,241200,0,59071.95,70.2,74.426
20060508,9822,89,17593,31270338.60,241289,0,-74048.4,69.78,74.119
20060509,9824,88,17417,31485791.29,241377,0,200511.159,70.7,74.95
20060510,9826,87,17243,31804994.22,241464,0,304135.02,72.14,76.21
20060511,9828,86,17071,32021046.12,241550,0,200898.048,73.33,77.042
20060512,9829,86,16900,31753553.14,241636,0,-282371.95,72.05,75.873
20060515,9831,85,16731,31201185.86,241721,0,-566636.42,69.42,73.528
20060516,9833,84,16564,31142050.59,241805,0,-73241.463,69.54,73.225
20060517,9834,83,16398,30999634.75,241888,0,-156447.835,69.54,72.578
20060518,9836,82,16234,31186211.19,241970,0,172708.032,69.46,73.292
20060519,9838,81,16072,31005746.69,242051,0,-194059.94,68.54,72.49
20060522,9839,81,15911,31093195.78,242132,0,73825.555,69.23,72.795
20060523,9841,80,15752,31442887.45,242212,0,335837.084,71.51,74.182
20060524,9842,79,15594,31061608.63,242291,0,-394805.56,69.71,72.552
20060525,9844,78,15438,31335890.53,242369,0,260705.116,71.12,73.628
20060526,9846,77,15284,31397616.97,242446,0,48231.431,71.37,73.827
20060530,9847,77,15131,31538430.65,242523,0,127284.15,72.03,74.352
20060531,9849,76,14980,31477988.71,242599,0,-73726.992,71.29,74.048
20060601,9850,75,14830,31271260.51,242674,0,-219794.694,70.34,73.142
20060602,9852,74,14682,31655270.16,242748,0,370805.872,72.33,74.67
20060605,9853,74,14535,31822820.04,242822,0,154387.728,72.33,75.306
20060606,9855,73,14390,31821791.94,242895,0,-14083.676,72.5,75.248
20060607,9856,72,14246,31546216.73,242967,0,-288316.365,70.82,74.061
20060608,9858,71,14104,31478062.47,243038,0,-80665.044,70.35,73.729
20060609,9859,71,13963,31700905.76,243109,0,210227.87,71.63,74.594
20060612,9860,70,13823,31459726.98,243179,0,-253562.687,70.36,73.551
20060613,9862,69,13685,31020119.16,243248,0,-451583.403,68.56,71.694
20060614,9863,69,13548,31020151.32,243317,0,-11919.152,69.14,71.645
20060615,9865,68,13413,31075080.10,243385,0,43067.109,69.5,71.822
20060616,9866,67,13279,31179849.76,243452,0,92973.07,69.5,72.204
20060619,9867,67,13146,31080501.97,243519,0,-111014.112,68.98,71.748
20060620,9869,66,13015,30998749.42,243585,0,-93267.777,68.94,71.365
20060621,9870,65,12885,31221606.17,243650,0,211188.195,70.7,72.232
20060622,9871,65,12756,31427140.13,243715,0,193945.4,70.49,73.028
20060623,9872,64,12628,31490592.38,243779,0,51911.295,70.54,73.241
20060626,9874,63,12502,31717900.50,243842,0,215744.415,71.8,74.126
20060627,9875,63,12377,31757467.43,243905,0,28041.83,71.92,74.241
20060628,9876,62,12253,31849445.92,243967,0,80488.65,72.19,74.571
20060629,9877,62,12130,32127934.39,244029,0,266899.898,73.52,75.665
20060630,9879,61,12009,32241157.50,244090,0,101516.064,75.53,76.081
20060705,9880,60,11889,32584963.76,244150,0,332206.49,75.19,77.442
20060706,9881,60,11770,32636550.49,244210,0,40040.6,75.14,77.606
20060707,9882,59,11652,32478908.44,244269,0,-168993.32,74.09,76.914
20060710,9883,59,11535,32343557.81,244328,0,-146561.4,73.63,76.314
20060711,9885,58,11420,32436765.68,244386,0,82094.208,74.16,76.65
20060712,9886,57,11306,32627037.66,244443,0,179134.938,74.95,77.383
20060713,9887,57,11193,33128909.76,244500,0,490597.101,76.7,79.39
20060714,9888,56,11081,33266102.69,244556,0,125917.5,77.03,79.905
20060717,9889,56,10970,32971181.63,244612,0,-305939.556,75.31,78.654
20060718,9890,55,10860,32646055.43,244667,0,-335852.276,73.55,77.281
20060719,9891,55,10751,32568261.24,244722,0,-88324.787,72.67,76.92
20060720,9892,54,10643,32431435.72,244776,0,-147322.644,73.09,76.318
20060721,9894,53,10537,32462288.25,244829,0,20316.408,74.94,76.401
20060724,9895,53,10432,32633335.57,244882,0,160607.824,74.71,77.057
20060725,9896,52,10328,32390615.79,244934,0,-252963.106,73.41,76.024
20060726,9897,52,10225,32454462.46,244986,0,53640.546,73.95,76.243
20060727,9898,51,10123,32647420.51,245037,0,182759.556,74.55,76.989
20060728,9899,51,10022,32386662.73,245088,0,-270765.885,73.25,75.884
20060731,9900,50,9922,32647172.68,245138,0,250479.936,74.41,76.906
20060801,9901,50,9823,32796437.98,245188,0,139238.384,74.92,77.474
20060802,9902,49,9725,32917069.91,245237,0,110579.788,75.82,78.831
20060803,9903,49,9628,32922607.67,245286,0,-4414.266,75.47,78.813
20060804,9904,48,9532,32884653.94,245334,0,-47830.77,75.47,78.618
20060807,9905,48,9437,33275355.20,245382,0,380758.368,76.99,80.17
20060808,9906,47,9343,33071216.35,245429,0,-213973.104,76.32,79.298
20060809,9907,47,9250,33000706.38,245476,0,-80255.283,76.36,78.971
20060810,9907,47,9157,32720811.34,245523,0,-289416.204,74.01,77.792
20060811,9908,46,9065,32860886.56,245569,0,130618.236,74.36,78.324
20060814,9909,46,8974,32725813.03,245615,0,-144394.572,73.56,77.736
20060815,9910,45,8884,32586162.07,245660,0,-148842.69,73.06,77.13
20060816,9911,45,8795,32463246.92,245705,0,-131919.42,71.9,76.593
20060817,9912,44,8707,32211069.77,245749,0,-260938.71,70.07,75.531
20060818,9913,44,8620,32293068.24,245793,0,73233.202,71.15,75.829
20060821,9914,43,8534,32516704.67,245836,0,214823.082,72.46,76.703
20060822,9915,43,8449,32523266.24,245879,0,-2212.524,72.64,76.694
20060823,9916,42,8365,32390485.36,245921,0,-141380.425,71.42,76.119
20060824,9916,42,8281,32451751.76,245963,0,52627.094,72.02,76.333
20060825,9917,42,8198,32467948.81,246005,0,7624.853,72.02,76.364
20060828,9918,41,8116,32226640.47,246046,0,-249695.075,70.62,75.349
20060829,9919,41,8035,32151946.88,246087,0,-82917.502,69.72,75.012
20060830,9920,40,7955,32200725.09,246127,0,40604.355,70.04,75.177
20060831,9920,40,7875,32255685.37,246167,0,46764.13,70.27,75.367
20060901,9921,40,7796,32046858.01,246207,0,-216873.127,69.2,74.486
20060905,9922,39,7718,32042215.33,246246,0,-12556.557,68.61,74.435
20060906,9923,39,7641,31833771.55,246285,0,-216203.988,67.51,73.557
20060907,9924,38,7565,31795871.22,246323,0,-45562.725,67.33,73.372
20060908,9924,38,7489,31587670.32,246361,0,-215778.948,66.26,72.496
20060911,9925,38,7414,31367972.63,246399,0,-227144.842,65.62,71.574
20060912,9926,37,7340,31013239.62,246436,0,-361960.131,63.77,70.105
20060913,9927,37,7267,31042569.16,246473,0,22179.24,63.98,70.195
20060914,9927,37,7194,30997907.73,246510,0,-51759.33,63.23,69.985
20060915,9928,36,7122,30969710.26,246546,0,-35250.93,63.54,69.842
20060918,9929,36,7051,31016657.54,246582,0,39940.452,63.81,70.004
20060919,9929,36,6980,30604573.39,246618,0,-418942.818,61.67,68.305
20060920,9930,35,6910,30229735.44,246653,0,-381518.046,60.47,66.758
20060921,9931,35,6841,30276569.54,246688,0,40204.439,61.05,66.921
20060922,9932,34,6773,30120510.63,246722,0,-162567.392,60.11,66.262
20060925,9932,34,6705,30202595.35,246756,0,75496.932,61.46,66.568
20060926,9933,34,6638,30135101.45,246790,0,-74026.8,61.46,66.268
20060927,9934,33,6572,30534181.35,246823,0,392642.89,61.02,67.859
20060928,9934,33,6506,30624685.60,246856,0,83919.82,62.77,68.199
20060929,9935,33,6441,30811922.83,246889,0,180698.592,62.92,68.931
20061002,9936,32,6377,30583748.70,246921,0,-234544.55,61.04,67.981
20061003,9936,32,6313,30216112.11,246953,0,-373838.394,58.69,66.467
20061004,9937,32,6250,30228198.66,246985,0,5926.872,59.42,66.491
20061005,9937,32,6187,30312939.60,247017,0,78541.23,60.04,66.809
20061006,9938,31,6125,30288192.22,247048,0,-30877.125,59.77,66.684
20061010,9939,31,6064,30200306.33,247079,0,-93878.24,58.53,66.304
20061011,9939,31,6003,30112592.00,247110,0,-93642.941,57.6,65.925
20061012,9940,30,5943,30219787.31,247140,0,101315.1,57.87,66.335
20061013,9941,30,5884,30312900.53,247170,0,87240.42,58.58,66.688
20061016,9941,30,5825,30616927.37,247200,0,298087.02,59.59,67.894
20061017,9942,29,5767,30602276.67,247229,0,-20517.6,58.94,67.811
20061018,9942,29,5709,30459730.75,247258,0,-148337.4,57.66,67.211
20061019,9943,29,5652,30520887.42,247287,0,55385.792,58.51,67.435
20061020,9943,29,5595,30403665.79,247316,0,-122901.639,56.83,66.938
20061023,9944,28,5539,30309374.60,247344,0,-99915.664,57.02,66.534
20061024,9945,28,5484,30414608.10,247372,0,99679.632,56.91,66.937
20061025,9945,28,5429,30801986.36,247400,0,381694.996,59.11,68.48
20061026,9946,27,5375,30596429.98,247427,0,-211279.6,60.37,67.626
20061027,9946,27,5321,30748387.17,247454,0,146229.357,60.76,68.217
20061030,9947,27,5268,30354849.45,247481,0,-399143.302,59.37,66.604
20061031,9947,27,5215,30402709.41,247508,0,42319.251,58.74,66.775
20061101,9948,26,5163,30412649.34,247534,0,4455.144,58.72,66.793
20061102,9948,26,5111,30221549.78,247560,0,-196541.996,57.89,65.999
20061103,9949,26,5060,30452262.88,247586,0,225279.6,59.15,66.909
20061106,9949,26,5009,30686529.18,247612,0,228769.464,60.03,67.833
20061107,9950,25,4959,30425499.75,247637,0,-266430.512,58.94,66.757
20061108,9950,25,4909,30574802.05,247662,0,143877.097,59.84,67.338
20061109,9951,25,4860,30877934.23,247687,0,297689.724,61.17,68.54
20061110,9951,25,4811,30605914.58,247712,0,-277409.44,59.6,67.42
20061113,9952,24,4763,30454125.17,247736,0,-157049.408,58.59,66.786
20061114,9952,24,4715,30391726.69,247760,0,-67631.928,58.29,66.513
20061115,9953,24,4668,30578775.25,247784,0,181855.84,58.77,67.247
20061116,9953,24,4621,30266076.08,247808,0,-317906.872,58.77,65.964
20061117,9954,23,4575,30423425.43,247831,0,152154.112,60.32,66.578
20061120,9954,23,4529,30473560.94,247854,0,45105.242,56.46,66.76
20061121,9955,23,4484,30682593.24,247877,0,203983.842,58.03,67.583
20061122,9955,23,4439,30584312.62,247900,0,-103364.709,58.45,67.166
20061127,9956,22,4395,30707909.34,247922,0,118496.2,60.33,67.644
20061128,9956,22,4351,30739576.88,247944,0,26527.654,61,67.751
20061129,9956,22,4307,30999174.51,247966,0,254390.544,62.47,68.777
20061130,9957,22,4264,31129839.50,247988,0,125470.796,63.14,69.283
20061201,9957,22,4221,31263514.82,248010,0,128457.784,63.44,69.801
20061204,9958,21,4179,31149882.87,248031,0,-118796.79,63.44,69.322
20061205,9958,21,4137,31119032.11,248052,0,-35964.495,62.44,69.177
20061206,9959,21,4096,30991115.24,248073,0,-132955.872,62.2,68.641
20061207,9959,21,4055,30890725.29,248094,0,-105431.025,62.5,68.216
20061208,9959,21,4014,30795013.31,248115,0,-100726.164,62.04,67.81
20061211,9960,20,3974,30661477.27,248135,0,-138448.17,61.23,67.252
20061212,9960,20,3934,30596892.92,248155,0,-69477.8,61.03,66.972
20061213,9961,20,3895,30615878.66,248175,0,14144.835,61.38,67.029
20061214,9961,20,3856,30840896.75,248195,0,220131.225,62.52,67.916
20061215,9961,20,3817,30926004.49,248215,0,80166.985,63.44,68.239
20061218,9962,19,3779,30638941.45,248234,0,-291900.84,62.22,67.063
20061219,9962,19,3741,30774363.09,248253,0,130571.084,63.16,67.589
20061220,9963,19,3704,31019721.05,248272,0,240557.157,63.23,68.558
20061221,9963,19,3667,30909296.67,248291,0,-115198.208,61.97,68.094
20061222,9963,19,3630,30873636.84,248310,0,-40471.433,63.23,67.931
20061227,9964,18,3594,30427099.47,248328,0,-451179.27,60.35,66.114
20061228,9964,18,3558,30445122.19,248346,0,13409.712,60.54,66.168
20070103,9964,18,3522,29974819.55,248364,0,-474837.552,58.33,64.256
20070104,9965,18,3487,29378962.74,248382,0,-600295.788,58.33,61.839
20070105,9965,18,3452,29560876.83,248400,0,177593.13,56.32,62.554
20070108,9965,18,3417,29657112.63,248418,0,91908,56.1,62.924
20070109,9966,17,3383,29565735.84,248435,0,-95640.93,55.65,62.539
20070110,9966,17,3349,29111078.16,248452,0,-458859.445,54.03,60.692
20070111,9967,17,3316,28398831.80,248469,0,-716287.116,51.89,57.809
20070112,9967,17,3283,28451055.20,248486,0,48202.986,53,58.003
20070116,9967,17,3250,28027873.64,248503,0,-427147.434,51.22,56.284
20070117,9967,17,3217,28179450.41,248520,0,147610.782,52.25,56.878
20070118,9968,16,3185,28099320.24,248536,0,-83999.76,50.49,56.54
20070119,9968,16,3153,28490450.81,248552,0,387219.088,52,58.098
20070122,9968,16,3121,28453106.43,248568,0,-41259.632,51.14,57.932
20070123,9969,16,3090,28886081.47,248584,0,429028.368,53.9,59.658
20070124,9969,16,3059,28978584.41,248600,0,88495.904,54.73,60.014
20070125,9969,16,3028,28786915.31,248616,0,-195648.2,53.59,59.227
20070126,9970,15,2998,29000712.62,248631,0,209831.904,55.43,60.071
20070129,9970,15,2968,28711516.88,248646,0,-293135.949,54.02,58.892
20070130,9970,15,2938,29283927.50,248661,0,568404.756,56.98,61.178
20070131,9971,15,2909,29617929.24,248676,0,329973.147,58.15,62.505
20070201,9971,15,2880,29490161.92,248691,0,-131798.28,57.31,61.975
20070202,9971,15,2851,29882190.49,248706,0,387957.96,59.03,63.535
20070205,9971,15,2822,29878325.75,248721,0,-7958.592,58.75,63.503
20070206,9972,14,2794,29822671.45,248735,0,-59693.04,58.89,63.263
20070207,9972,14,2766,29540876.47,248749,0,-285796.515,57.72,62.114
20070208,9972,14,2738,29964053.52,248763,0,419142.065,59.72,63.799
20070209,9973,14,2711,30063094.96,248777,0,95027.466,59.9,64.181
20070212,9973,14,2684,29662549.31,248791,0,-404511.402,57.82,62.555
20070213,9973,14,2657,29904111.90,248805,0,237595.405,59.06,63.51
20070214,9973,14,2630,29607762.15,248819,0,-300307.635,58,62.303
20070215,9974,13,2604,29524302.90,248832,0,-87335.469,58,61.952
20070216,9974,13,2578,29813831.57,248845,0,285659.136,58,63.1
20070220,9974,13,2552,29683384.63,248858,0,-134376.3,59.41,62.56
20070221,9974,13,2526,29971751.36,248871,0,284444.694,59.53,63.703
20070222,9975,13,2501,30354170.47,248884,0,378532.791,59.56,65.224
20070223,9975,13,2476,30578622.85,248897,0,220511.224,60.53,66.11
20070226,9975,13,2451,30637112.15,248910,0,54508.443,61.4,66.329
20070227,9975,13,2426,30649811.29,248923,0,8711.85,61.47,66.364
20070228,9976,12,2402,30735392.82,248935,0,81646.744,61.8,66.692
20070301,9976,12,2378,30790620.10,248947,0,51280.61,62.01,66.898
20070302,9976,12,2354,30667848.53,248959,0,-126714.023,61.65,66.389
20070305,9976,12,2330,30330171.74,248971,0,-341571.748,60.08,65.017
20070306,9977,12,2307,30490347.64,248983,0,156353.788,60.7,65.645
20070307,9977,12,2284,30757134.61,248995,0,262926.048,61.83,66.701
20070308,9977,12,2261,30796619.01,249007,0,35606.285,61.65,66.844
20070309,9977,12,2238,30533279.22,249019,0,-267184.511,60.06,65.771
20070312,9978,11,2216,30336059.43,249030,0,-200958.333,58.92,64.964
20070313,9978,11,2194,30274514.78,249041,0,-65245.86,57.94,64.702
20070314,9978,11,2172,30335993.63,249052,0,57777.512,58.17,64.934
20070315,9978,11,2150,30236828.00,249063,0,-102858.476,57.56,64.521
20070316,9978,11,2128,30171263.72,249074,0,-69239.514,57.12,64.243
20070319,9979,11,2107,30219698.99,249085,0,44833.32,56.6,64.423
20070320,9979,11,2086,30141607.87,249096,0,-81699.88,56.74,64.095
20070321,9979,11,2065,30261551.45,249107,0,116327.832,57.37,64.562
20070322,9979,11,2044,30645133.83,249118,0,379888.175,60.65,66.087
20070323,9980,10,2024,30751949.76,249128,0,103134.852,61.49,66.501
20070326,9980,10,2004,31019743.66,249138,0,264075.68,62.92,67.561
20070327,9980,10,1984,31135097.52,249148,0,111613.824,62.94,68.009
20070328,9980,10,1964,31342174.56,249158,0,203304.768,64.09,68.825
20070329,9980,10,1944,31537604.88,249168,0,191602.502,66.04,69.594
20070330,9981,10,1925,31573272.77,249178,0,31893.504,65.88,69.722
20070402,9981,10,1906,31640093.36,249188,0,63042.034,65.95,69.975
20070403,9981,10,1887,31533462.29,249198,0,-110390.284,64.65,69.532
20070404,9981,10,1868,31653832.69,249208,0,116624.664,64.39,70
20070405,9981,10,1849,31729607.27,249218,0,72021.112,64.29,70.289
20070410,9982,9,1831,31577996.71,249227,0,-155262.814,61.9,69.666
20070411,9982,9,1813,31550236.39,249236,0,-31402.602,62.02,69.54
20070412,9982,9,1795,31773237.26,249245,0,219327.68,63.86,70.42
20070413,9982,9,1777,31799107.12,249254,0,22182.805,63.64,70.509
20070416,9982,9,1759,31532359.45,249263,0,-270440.59,63.85,69.424
20070417,9982,9,1741,31261329.88,249272,0,-274687.826,63.11,68.322
20070418,9983,9,1724,31257425.70,249281,0,-7478.16,63.14,68.292
20070419,9983,9,1707,31141571.67,249290,0,-119405.599,61.84,67.813
20070420,9983,9,1690,31248844.96,249299,0,103704.64,63.39,68.229
20070423,9983,9,1673,31621168.73,249308,0,368713.221,65.35,69.708
20070424,9983,9,1656,31398662.22,249317,0,-226122.356,63.91,68.801
20070425,9983,9,1639,31687250.17,249326,0,284969.331,65.12,69.944
20070426,9984,8,1623,31563919.06,249334,0,-126906.934,65.07,69.435
20070427,9984,8,1607,31845764.16,249342,0,278256.744,66.47,70.551
20070430,9984,8,1591,31752867.54,249350,0,-96495.354,65.71,70.164
20070502,9984,8,1575,31451970.03,249358,0,-304456.35,63.68,68.943
20070503,9984,8,1559,31378196.13,249366,0,-77300.98,63.2,68.633
20070504,9984,8,1543,31218113.06,249374,0,-163584.096,61.94,67.977
20070507,9985,8,1528,31062930.57,249382,0,-158601.864,61.48,67.341
20070508,9985,8,1513,31134181.29,249390,0,67831.904,62.27,67.613
20070509,9985,8,1498,31000929.44,249398,0,-136665.72,61.56,67.065
20070510,9985,8,1483,31062196.88,249406,0,57860.336,61.82,67.297
20070511,9985,8,1468,31198051.87,249414,0,132434.586,62.38,67.828
20070514,9985,8,1453,31140378.06,249422,0,-61106.43,62.47,67.583
20070515,9985,8,1438,31302199.69,249430,0,158382.97,63.18,68.218
20070516,9986,7,1424,31231748.19,249437,0,-73831.28,62.56,67.922
20070517,9986,7,1410,31587359.71,249444,0,352205.044,64.87,69.334
20070518,9986,7,1396,31604265.73,249451,0,13469.976,64.95,69.388
20070521,9986,7,1382,31804538.59,249458,0,196816.839,66.28,70.177
20070522,9986,7,1368,31534087.54,249465,0,-273904.884,64.98,69.079
20070523,9986,7,1354,31642296.45,249472,0,104775.3,65.08,69.499
20070524,9986,7,1340,31462355.93,249479,0,-183361.92,63.59,68.764
20070525,9987,7,1327,31580474.90,249486,0,114760.34,64.76,69.224
20070529,9987,7,1314,31128759.72,249493,0,-455062.464,63.16,67.4
20070530,9987,7,1301,31123093.53,249500,0,-8981.748,63.5,67.364
20070531,9987,7,1288,31172323.40,249507,0,45908,64.02,67.548
20070601,9987,7,1275,31425669.13,249514,0,250006.014,65.09,68.55
20070604,9987,7,1262,31694277.19,249521,0,265233.382,66.22,69.613
20070605,9987,7,1249,31633289.13,249528,0,-64376.418,65.62,69.355
20070606,9988,6,1237,31677284.29,249534,0,40673.064,65.97,69.518
20070607,9988,6,1225,31814371.64,249540,0,133750.224,66.93,70.054
20070608,9988,6,1213,31345813.57,249546,0,-471880.14,64.76,68.163
20070611,9988,6,1201,31562724.04,249552,0,213611.376,65.97,69.019
20070612,9988,6,1189,31510133.52,249558,0,-55899.648,65.36,68.795
20070613,9988,6,1177,31686393.06,249564,0,172943.694,66.27,69.488
20070614,9988,6,1165,31898125.62,249570,0,208385.94,67.66,70.323
20070615,9988,6,1153,32024032.13,249576,0,122538.87,68,70.814
20070618,9988,6,1141,32210861.40,249582,0,183438.36,69.1,71.549
20070619,9989,6,1130,32195978.78,249588,0,-18219.486,69.11,71.476
20070620,9989,6,1119,32041814.41,249594,0,-157490.028,68.2,70.845
20070621,9989,6,1108,31953024.59,249600,0,-92100.186,67.93,70.476
20070622,9989,6,1097,32116332.12,249606,0,159993.6,68.9,71.117
20070625,9989,6,1086,32137381.58,249612,0,17722.026,68.94,71.188
20070626,9989,6,1075,31775265.97,249618,0,-365431.968,67.78,69.724
20070627,9989,6,1064,31844216.10,249624,0,65649.534,68.98,69.987
20070628,9989,6,1053,31912181.31,249630,0,64652.616,69.57,70.246
20070629,9989,6,1042,32187608.36,249636,0,272096.7,70.69,71.336
20070702,9990,5,1032,32378374.02,249641,0,187476.636,71.42,72.087
20070703,9990,5,1022,32465804.13,249646,0,84129.017,71.1,72.424
20070705,9990,5,1012,32493335.08,249651,0,24215.662,71.82,72.521
20070706,9990,5,1002,32633221.66,249656,0,136559.097,72.82,73.068
20070709,9990,5,992,32621574.77,249661,0,-14979.36,72.2,73.008
20070710,9990,5,982,32739007.59,249666,0,114095.077,72.82,73.465
20070711,9990,5,972,32676440.41,249671,0,-65911.824,72.57,73.201
20070712,9990,5,962,32646822.87,249676,0,-32956.572,72.51,73.069
20070713,9990,5,952,32818205.78,249681,0,168031.948,73.94,73.742
20070716,9990,5,942,32783621.14,249686,0,-37951.512,74.16,73.59
20070717,9991,5,933,32709507.25,249691,0,-77402.66,74.03,73.28
20070718,9991,5,924,32988707.92,249696,0,275908.555,75.06,74.385
20070719,9991,5,915,33147590.81,249701,0,155560.608,75.93,75.008
20070720,9991,5,906,33135441.19,249706,0,-15481.462,75.58,74.946
20070723,9991,5,897,33003922.90,249711,0,-134841.24,74.7,74.406
20070724,9991,5,888,32712316.02,249716,0,-294908.691,73.52,73.225
20070725,9991,5,879,33050938.06,249721,0,335368.588,70.74,74.568
20070726,9991,5,870,32865217.80,249726,0,-189038.797,74.96,73.811
20070727,9991,5,861,33147484.04,249731,0,278943.942,77.03,74.928
20070730,9991,5,852,33118611.91,249736,0,-32215.299,76.84,74.799
20070731,9991,5,843,33398173.21,249741,0,276208.016,78.22,75.905
20070801,9992,4,835,33263600.20,249745,0,-137857.032,76.54,75.353
20070802,9992,4,827,33353537.61,249749,0,86661.515,76.87,73.093
20070803,9992,4,819,33286380.45,249753,0,-70429.218,75.49,72.811
20070806,9992,4,811,32725178.00,249757,0,-564441.78,72.07,70.551
20070807,9992,4,803,32769585.22,249761,0,41209.905,72.43,70.716
20070808,9992,4,795,32623177.25,249765,0,-149606.839,72.18,70.117
20070809,9992,4,787,32539941.07,249769,0,-86418.69,71.6,69.771
20070810,9992,4,779,32448952.98,249773,0,-94162.913,71.47,69.394
20070813,9992,4,771,32317494.07,249777,0,-134627.647,71.62,68.855
20070814,9992,4,763,32377108.05,249781,0,56449.602,72.39,69.081
20070815,9992,4,755,32608334.85,249785,0,228050.053,73.34,69.994
20070816,9992,4,747,32258565.26,249789,0,-352946.205,71.01,68.581
20070817,9993,4,740,32358817.66,249793,0,97167.921,71.99,68.97
20070820,9993,4,733,32271229.28,249797,0,-90674.859,71.13,68.607
20070821,9993,4,726,32088448.23,249801,0,-185848.968,69.48,67.863
20070822,9993,4,719,32073015.14,249805,0,-18485.274,69.32,67.789
20070823,9993,4,712,32186734.74,249809,0,110663.615,70.04,68.232
20070824,9993,4,705,32352684.73,249813,0,162875.468,71.39,68.884
20070827,9993,4,698,32477185.79,249817,0,121409.118,71.98,69.37
20070828,9993,4,691,32377611.22,249821,0,-102674.787,71.74,68.959
20070829,9993,4,684,32514869.81,249825,0,134153.877,73.52,69.496
20070830,9993,4,677,32445785.02,249829,0,-72199.425,73.37,69.207
20070831,9993,4,670,32581558.09,249833,0,132659.199,74.05,69.738
20070904,9993,4,663,32779559.78,249837,0,194869.74,75.08,70.518
20070905,9993,4,656,32724500.16,249841,0,-58212.021,75.74,70.285
20070906,9993,4,649,32843578.37,249845,0,115926.224,76.31,70.749
20070907,9994,3,643,32967091.30,249848,0,120425.29,76.71,71.231
20070910,9994,3,637,33069882.91,249851,0,99689.352,77.5,71.63
20070911,9994,3,631,33257887.58,249854,0,184889.74,78.24,72.37
20070912,9994,3,625,33492142.57,249857,0,231114.95,79.92,73.295
20070913,9994,3,619,33412349.91,249860,0,-82952.524,80.1,72.963
20070914,9994,3,613,33356780.34,249863,0,-58717.1,79.11,72.728
20070917,9994,3,607,33516596.30,249866,0,156664.101,80.57,73.355
20070918,9994,3,601,33597974.69,249869,0,78208.058,81.52,73.668
20070919,9994,3,595,33790304.89,249872,0,189150.833,81.94,74.425
20070920,9994,3,589,34007648.29,249875,0,214140.304,83.33,75.282
20070921,9994,3,583,34176785.95,249878,0,165917,83.36,75.946
20070924,9994,3,577,34282465.97,249881,0,102449.98,82.67,76.356
20070925,9994,3,571,34002333.24,249884,0,-283365.054,81.64,75.222
20070926,9994,3,565,33843610.35,249887,0,-161924.832,80.31,74.574
20070927,9994,3,559,34082459.10,249890,0,235643.441,82.99,75.517
20070928,9994,3,553,33967727.53,249893,0,-117948.08,81.67,75.045
20071001,9994,3,547,33787504.87,249896,0,-183421.462,80.25,74.311
20071002,9995,3,542,33701395.19,249899,0,-89212.872,80.06,73.954
20071003,9995,3,537,33690746.65,249902,0,-13744.445,79.98,73.899
20071004,9995,3,532,34085945.28,249905,0,392096.238,81.45,75.468
20071005,9995,3,527,34276007.13,249908,0,186928.94,81.23,76.216
20071009,9995,3,522,34074725.71,249911,0,-204424.744,80.27,75.398
20071010,9995,3,517,34307276.42,249914,0,229418.298,81.31,76.316
20071011,9995,3,512,34463633.62,249917,0,153197.282,83.09,76.929
20071012,9995,3,507,34531287.68,249920,0,64478.586,83.7,77.187
20071015,9995,3,502,34885618.36,249923,0,351137.6,86.14,78.592
20071016,9995,3,497,35057295.29,249926,0,168448.102,87.62,79.266
20071017,9995,3,492,34930575.29,249929,0,-129961.52,87.41,78.746
20071018,9995,3,487,35209238.77,249932,0,275421.758,89.48,79.848
20071019,9995,3,482,35144017.08,249935,0,-68481.368,88.61,79.574
20071022,9995,3,477,35076784.66,249938,0,-70481.67,87.57,79.292
20071023,9995,3,472,35033784.55,249941,0,-46238.53,86.48,79.107
20071024,9995,3,467,35303970.92,249944,0,266936.988,89.36,80.175
20071025,9995,3,462,35734664.21,249947,0,427404.24,92.97,81.885
20071026,9995,3,457,35999426.77,249950,0,261444.562,91.87,82.931
20071029,9995,3,452,36548165.15,249953,0,545390.9,93.53,85.113
20071030,9995,3,447,36064632.38,249956,0,-486908.444,90.39,83.165
20071031,9996,2,443,36552560.31,249958,0,484664.684,94.54,85.104
20071101,9996,2,439,36408883.09,249960,0,-146975.304,93.49,84.516
20071102,9996,2,435,36787869.35,249962,0,375689.88,95.94,86.019
20071105,9996,2,431,36561473.18,249964,0,-229715.078,93.99,85.1
20071106,9996,2,427,37020458.34,249966,0,455684.372,93.99,86.923
20071107,9996,2,423,37165036.20,249968,0,141230.79,96.38,87.488
20071108,9996,2,419,37120147.37,249970,0,-48243.824,95.47,87.295
20071109,9996,2,415,37198493.21,249972,0,74991,96.33,87.595
20071113,9996,2,411,36298184.95,249974,0,-903648.78,91.18,83.98
20071114,9996,2,407,36630430.90,249976,0,328965.784,94.1,85.296
20071115,9996,2,403,36475250.23,249978,0,-158484.784,93.44,84.662
20071116,9996,2,399,36799270.34,249980,0,320721.774,95.1,85.945
20071119,9996,2,395,37035328.57,249982,0,232731.38,95.75,86.876
20071120,9996,2,391,37633643.79,249984,0,594957.16,98.83,89.256
20071121,9996,2,387,37574049.58,249986,0,-62995.968,97.79,89.004
20071123,9996,2,383,37763437.72,249988,0,185989.584,98.18,89.748
20071126,9996,2,379,37712102.18,249990,0,-54747.372,97.71,89.529
20071127,9996,2,375,37212766.89,249992,0,-502729.89,94.43,87.518
20071128,9996,2,371,36677123.59,249994,0,-538982.752,90.63,85.362
20071129,9996,2,367,36828168.45,249996,0,147746.454,91.08,85.953
20071130,9996,2,363,36609723.04,249998,0,-221746.452,88.72,85.066
20071203,9996,2,359,36889506.80,250000,0,276497.788,89.32,86.172
20071204,9996,2,355,36904311.20,250002,0,11500,88.33,86.218
20071205,9996,2,351,36720361.96,250004,0,-187251.498,87.5,85.469
20071206,9996,2,347,37121166.82,250006,0,397506.36,90.24,87.059
20071207,9997,2,344,36892895.74,250008,0,-231505.556,88.29,86.133
20071210,9997,2,341,36850359.23,250010,0,-45751.464,87.87,85.95
20071211,9997,2,338,37176590.19,250012,0,323012.92,90.03,87.242
20071212,9997,2,335,37919382.92,250014,0,739535.496,94.4,90.2
20071213,9997,2,332,37669678.99,250016,0,-253014.168,92.26,89.188
20071214,9997,2,329,37621463.02,250018,0,-51503.296,91.28,88.982
20071217,9997,2,326,37642745.87,250020,0,18001.296,90.64,89.054
20071218,9997,2,323,37435761.88,250022,0,-210266.82,90.5,88.213
20071219,9997,2,320,37579042.12,250024,0,140012.32,91.05,88.773
20071220,9997,2,317,37545317.71,250026,0,-37003.552,90.97,88.625
20071221,9997,2,314,37744871.62,250028,0,196270.41,93.32,89.41
20071227,9997,2,311,38198481.43,250030,0,450300.428,96.63,91.211
20071228,9997,2,308,38111064.36,250032,0,-90760.89,96.01,90.848
20080102,9997,2,305,38851238.35,250034,0,736844.304,93.63,93.795
20080103,9997,2,302,39001413.88,250036,0,146769.958,99.19,94.382
20080104,9997,2,299,38924566.10,250038,0,-80261.556,97.92,94.061
20080107,9997,2,296,38392383.88,250040,0,-535581.396,95.1,91.919
20080108,9997,2,293,38510012.48,250042,0,114268.28,96.34,92.376
20080109,9997,2,290,38179324.12,250044,0,-334056.112,95.68,91.04
20080110,9997,2,287,37826096.79,250046,0,-356562.744,93.72,89.614
20080111,9997,2,284,37671371.82,250048,0,-158029.072,92.7,88.982
20080114,9997,2,281,37950721.06,250050,0,276052.992,94.21,90.086
20080115,9997,2,278,37662474.46,250052,0,-291558.3,91.91,88.92
20080116,9997,2,275,37387702.09,250054,0,-278057.824,90.85,87.808
20080117,9997,2,272,37193170.73,250056,0,-197792.714,90.14,87.017
20080118,9997,2,269,37214921.98,250058,0,18504.144,90.58,87.091
20080122,9997,2,266,37074385.32,250060,0,-143783.35,89.86,86.516
20080123,9997,2,263,36650010.54,250062,0,-427602.6,87.32,84.806
20080124,9997,2,260,37081816.95,250064,0,428606.268,89.41,86.52
20080125,9997,2,257,37543422.85,250066,0,458367.312,90.71,88.353
20080128,9997,2,254,37713993.36,250068,0,167294.154,90.99,89.022
20080129,9997,2,251,37832566.69,250070,0,115281.348,91.65,89.483
20080130,9997,2,248,38010169.02,250072,0,174298.79,92.34,90.18
20080131,9998,1,246,37986635.60,250073,0,-26757.704,91.76,90.073
20080201,9998,1,244,37513713.43,250074,0,-476138.992,88.97,88.169
20080204,9998,1,242,37689195.51,250075,0,172300.986,90.02,88.858
20080205,9998,1,240,37331029.07,250076,0,-361358.375,88.42,87.413
20080206,9998,1,238,37075611.22,250077,0,-258578.584,87.15,86.379
20080207,9998,1,236,37283316.46,250078,0,204562.986,88.12,87.197
20080208,9998,1,234,37983450.02,250079,0,696967.386,91.78,89.984
20080211,9998,1,232,38392554.07,250080,0,405878.217,93.6,91.607
20080212,9998,1,230,38305031.97,250081,0,-90779.04,92.79,91.244
20080213,9998,1,228,38430321.43,250082,0,122039.528,92.79,91.732
20080214,9998,1,226,38916495.09,250083,0,482908.342,95.47,93.663
20080215,9998,1,224,38845774.82,250084,0,-74024.568,95.51,93.367
20080219,9998,1,222,39658354.28,250085,0,809271.824,100.01,96.603
20080220,9998,1,220,39736253.73,250086,0,74525.33,100.75,96.901
20080221,9998,1,218,39473788.98,250087,0,-265841.418,98.91,95.838
20080222,9998,1,216,39517158.58,250088,0,40013.92,98.91,95.998
20080225,9998,1,214,39677073.81,250089,0,156555.088,99.41,96.624
20080226,9998,1,212,40083343.08,250090,0,402893.379,100.89,98.235
20080227,9998,1,210,39954451.39,250091,0,-132297.61,99.65,97.706
20080228,9998,1,208,40555320.30,250092,0,597467.399,102.6,100.095
20080229,9998,1,206,40425969.52,250093,0,-132798.852,101.85,99.564
20080303,9998,1,204,40541700.23,250094,0,112291.757,102.46,100.013
20080304,9998,1,202,39852382.17,250095,0,-692760.38,99.52,97.243
20080305,9998,1,200,40638326.61,250096,0,782547.255,104.52,100.372
20080306,9998,1,198,40825859.24,250097,0,184070.656,105.48,101.108
20080307,9998,1,196,40577237.80,250098,0,-252097.776,105.16,100.1
20080310,9998,1,194,40795784.01,250099,0,215084.28,107.9,100.96
20080311,9998,1,192,41011849.29,250100,0,212584.15,108.76,101.81
20080312,9998,1,190,41355235.95,250101,0,339885.9,109.93,103.169
20080313,9998,1,188,41608115.67,250102,0,249350.697,110.33,104.166
20080314,9998,1,186,41488864.61,250103,0,-122800.082,110.21,103.675
20080317,9998,1,184,40546005.28,250104,0,-946389.752,105.68,99.891
20080318,9998,1,182,41440088.09,250105,0,890620.344,109.42,103.452
20080319,9998,1,180,40294139.91,250106,0,-1149482.58,109.62,98.856
20080320,9998,1,178,40128997.24,250107,0,-168571.444,102.65,98.182
20080325,9998,1,176,40211193.18,250108,0,78783.705,100.98,98.497
20080326,9998,1,174,40975700.47,250109,0,761078.644,105.9,101.54
20080327,9998,1,172,41274822.49,250110,0,295628.838,107.59,102.722
20080328,9998,1,170,40976202.81,250111,0,-302132.88,105.63,101.514
20080331,9998,1,168,40252111.13,250112,0,-727572.899,101.59,98.605
20080401,9998,1,166,40078203.81,250113,0,-177329.408,100.98,97.896
20080402,9998,1,164,40859221.01,250114,0,777601.317,104.84,101.005
20080403,9998,1,162,40624838.96,250115,0,-237858.414,103.84,100.054
20080404,9998,1,160,41180305.16,250116,0,552003.805,106.23,102.261
20080407,9998,1,158,41779585.91,250117,0,595776.312,105.03,104.643
20080408,9998,1,156,41685099.36,250118,0,-98045.864,108.5,104.251
20080409,9998,1,154,42097098.55,250119,0,408442.694,110.87,105.884
20080410,9998,1,152,42104688.41,250120,0,4001.904,110.12,105.9
20080411,9998,1,150,42198070.11,250121,0,89793.08,110.15,106.259
20080414,9998,1,148,42448288.73,250122,0,246619.306,111.76,107.245
20080415,9999,1,147,42937785.37,250123,0,485987.046,113.79,109.188
20080416,9999,1,146,43289756.61,250124,0,348421.339,114.93,110.581
20080417,9999,1,145,43373374.27,250125,0,80039.68,114.86,110.901
20080418,9999,1,144,43694369.40,250126,0,317408.625,116.69,112.17
20080421,9999,1,143,43848558.23,250127,0,150575.852,117.48,112.772
20080422,9999,1,142,44180602.19,250128,0,328416.751,119.38,114.085
20080423,9999,1,141,44337085.22,250129,0,152828.208,120.44,114.696
20080424,9999,1,140,43791716.14,250130,0,-549033.155,117.16,112.501
20080425,9999,1,139,44132766.36,250131,0,337425.37,121.57,113.85
20080428,9999,1,138,44316259.86,250132,0,179844.189,118.75,114.569
20080429,9999,1,137,43687336.91,250133,0,-632583.828,115.63,112.04
20080430,9999,1,136,43168417.47,250134,0,-522527.837,113.46,109.951
20080502,9999,1,135,43856353.83,250135,0,684366.624,116.32,112.687
20080505,9999,1,134,44780979.32,250136,0,920997.07,119.97,116.369
20080506,9999,1,133,45307717.96,250137,0,523034.376,121.85,118.46
20080507,9999,1,132,45840505.80,250138,0,529039.755,123.53,120.575
20080508,9999,1,131,46087430.82,250139,0,243134.136,123.7,121.547
20080509,9999,1,130,46766869.16,250140,0,675625.439,125.97,124.248
20080512,9999,1,129,46451055.77,250141,0,-319678.92,124.24,122.97
20080513,9999,1,128,46712792.96,250142,0,257895.371,125.8,124.001
20080514,9999,1,127,46588081.17,250143,0,-128572.988,124.23,123.487
20080515,9999,1,126,46482619.78,250144,0,-109312.491,124.12,123.05
20080516,9999,1,125,47017520.34,250145,0,531055.712,126.3,125.173
20080519,9999,1,124,47322333.17,250146,0,300924.435,127.06,126.376
20080520,9999,1,123,48119711.09,250147,0,793463.112,129.08,129.548
20080521,9999,1,122,49176562.10,250148,0,1052868.723,132.78,133.757
20080522,9999,1,121,48511980.77,250149,0,-668645.604,130.22,131.084
20080523,9999,1,120,48562020.68,250150,0,46027.416,131.6,131.268
20080527,9999,1,119,47997443.48,250151,0,-568590.95,128.85,128.995
20080528,9999,1,118,48198533.24,250152,0,197118.988,131.04,129.783
20080529,9999,1,117,47424042.66,250153,0,-778473.024,126.63,126.671
20080530,9999,1,116,47464985.53,250154,0,37022.644,126.36,126.819
20080602,9999,1,115,47682541.94,250155,0,213631.516,127.76,127.673
20080603,9999,1,114,47054339.11,250156,0,-632141.685,124.31,125.146
20080604,9999,1,113,46549158.23,250157,0,-509067.46,122.3,123.111
20080605,9999,1,112,47660955.24,250158,0,1107945.353,127.79,127.54
20080606,9999,1,111,50012639.43,250159,0,2347732.83,138.55,136.925
20080609,9999,1,110,49450665.11,250160,0,-566109.817,134.55,134.662
20080610,9999,1,109,48881635.84,250161,0,-573116.56,131.31,132.371
20080611,9999,1,108,50021163.47,250162,0,1135480.779,136.38,136.91
20080612,9999,1,107,50270210.43,250163,0,244908.598,136.74,137.889
20080613,9999,1,106,49856094.31,250164,0,-418272.536,134.87,136.217
20080616,9999,1,105,49940770.16,250165,0,80552.808,134.62,136.539
20080617,9999,1,104,49748770.00,250166,0,-196129.36,134.01,135.755
20080618,9999,1,103,50193679.01,250167,0,440792.492,136.68,137.517
20080619,9999,1,102,49292972.32,250168,0,-904854.039,131.93,133.9
20080620,9999,1,101,49679807.37,250169,0,382757.04,134.63,135.43
20080623,9999,1,100,50080685.72,250170,0,396768.034,136,137.016
20080624,9999,1,99,50280461.44,250171,0,195632.94,136.4,137.798
20080625,9999,1,98,49792531.45,250172,0,-492086.357,134,135.831
20080626,9999,1,97,50869642.14,250173,0,1072987.708,139.65,140.12
20080627,9999,1,96,51141286.79,250174,0,267434.937,140.21,141.189
20080630,9999,1,95,51226824.57,250175,0,81306.55,140,141.514
20080701,9999,1,94,51452468.49,250176,0,221404.875,140.97,142.399
20080702,9999,1,93,52053147.77,250177,0,596419.584,143.57,144.783
20080703,9999,1,92,52458490.96,250178,0,401033.731,145.28,146.386
20080707,9999,1,91,51677019.85,250179,0,-785809.098,141.38,143.245
20080708,9999,1,90,50504447.97,250180,0,-1176842.016,136.04,138.541
20080709,9999,1,89,50375528.55,250181,0,-133095.76,136.06,138.009
20080710,9999,1,88,51597581.29,250182,0,1217881.108,141.66,142.877
20080711,9999,1,87,52394431.26,250183,0,792576.576,145.66,146.045
20080714,9999,1,86,52530864.55,250184,0,132096.624,145.18,146.573
20080715,9999,1,85,51192217.97,250185,0,-1342987.712,138.74,141.205
20080716,9999,1,84,50164188.57,250186,0,-1032263.31,138.6,137.079
20080717,9999,1,83,48917400.93,250187,0,-1250930,129.29,132.079
20080718,9999,1,82,48629975.28,250188,0,-291467.855,128.88,130.914
20080721,9999,1,81,49114857.99,250189,0,480861.336,131.04,132.836
20080722,9999,1,80,48462168.94,250190,0,-656746.125,127.95,130.211
20080723,9999,1,79,47474666.57,250191,0,-991502.97,123.69,126.248
20080724,9999,1,78,47548642.70,250192,0,70053.48,124.74,126.528
20080725,9999,1,77,47124741.47,250193,0,-427828.32,123.26,124.818
20080728,9999,1,76,47408351.90,250194,0,279715.774,124.74,125.936
20080729,9999,1,75,46889611.43,250195,0,-522655.266,122.19,123.847
20080730,9999,1,74,47781177.17,250196,0,887691.86,122.77,127.395
20080731,9999,1,73,47321760.69,250197,0,-463362.992,124.08,125.543
20080801,9999,1,72,47489798.86,250198,0,164129.232,123.26,126.199
20080804,9999,1,71,46691084.20,250199,0,-802635.184,121.41,121.824
20080805,9999,1,70,45847014.19,250200,0,-847924.411,119.17,118.435
20080806,9999,1,69,45600100.07,250201,0,-250700.4,118.58,117.433
20080807,9999,1,68,45753988.64,250202,0,150120.6,120.02,118.033
20080808,9999,1,67,45119498.80,250203,0,-638265.302,115.2,115.482
20080811,9999,1,66,44995869.43,250204,0,-127353.327,114.45,114.973
20080812,9999,1,65,44607512.39,250205,0,-392069.668,113.02,113.406
20080813,9999,1,64,45131122.92,250206,0,519925.99,116,115.484
20080814,9999,1,63,45040270.49,250207,0,-94577.868,115,115.106
20080815,9999,1,62,44935397.59,250208,0,-108589.838,113.77,114.672
20080818,9999,1,61,44697404.31,250209,0,-241700.928,112.88,113.706
20080819,9999,1,60,44989585.55,250210,0,288490.977,114.53,114.859
20080820,9999,1,59,45480458.51,250211,0,487158.87,114.98,116.806
20080821,9999,1,58,47048536.99,250212,0,1564319.172,120.93,123.058
20080822,9999,1,57,45746809.30,250213,0,-1305606.216,114.7,117.84
20080825,9999,1,56,45764345.97,250214,0,13761.715,115.27,117.895
20080826,9999,1,55,45822920.69,250215,0,54796.866,116.77,118.114
20080827,9999,1,54,46250819.54,250216,0,424114.425,118.65,119.809
20080828,9999,1,53,45838776.65,250217,0,-415858.992,116.09,118.147
20080829,9999,1,52,45700686.61,250218,0,-141873.039,115.96,117.58
20080902,9999,1,51,45016603.54,250219,0,-687849.282,110.21,114.831
20080903,9999,1,50,44707790.63,250220,0,-312523.531,109.35,113.582
20080904,9999,1,49,44301864.94,250221,0,-409610.14,107.89,111.945
20080905,10000,0,49,43805217.31,250221,0,-500191.779,106.23,109.946
20080908,10000,0,49,43764432.61,250221,0,-44289.117,106.34,109.769
20080909,10000,0,49,43024777.40,250221,0,-743156.37,103.26,106.799
20080910,10000,0,49,42843556.28,250221,0,-184663.098,102.58,106.061
20080911,10000,0,49,42469150.06,250221,0,-377833.71,100.87,104.551
20080912,10000,0,49,42603913.62,250221,0,131366.025,101.18,105.076
20080915,10000,0,49,41304170.96,250221,0,-1303150.968,95.71,99.868
20080916,10000,0,49,39930509.13,250221,0,-1376966.163,91.15,94.365
20080917,10000,0,49,40962362.10,250221,0,1028658.531,91.16,98.476
20080918,10000,0,49,41310693.85,250221,0,345054.759,97.88,99.855
20080919,10000,0,49,42341155.91,250221,0,1027157.205,104.55,103.96
20080922,10000,0,49,43762045.17,250221,0,1417501.965,120.92,109.625
20080923,10000,0,49,43035651.48,250221,0,-729894.657,107.86,106.708
20080924,10000,0,49,42912232.28,250221,0,-126862.047,106.73,106.201
20080925,10000,0,49,43483666.93,250221,0,568001.67,108.02,108.471
20080926,10000,0,49,43391310.98,250221,0,-95834.643,106.9,108.088
20080929,10000,0,49,41450064.67,250221,0,-1944717.612,96.38,100.316
20080930,10000,0,49,42174267.38,250221,0,720886.701,100.64,103.197
20081001,10000,0,49,41713981.81,250221,0,-463659.513,98.53,101.344
20081002,10000,0,49,40537276.69,250221,0,-1180042.236,93.97,96.628
20081003,10000,0,49,40240504.69,250221,0,-300014.979,93.89,95.429
20081006,10000,0,49,38870761.31,250221,0,-1372962.627,87.82,89.942
20081007,10000,0,49,39174386.39,250221,0,300515.421,90.06,91.143
20081008,10000,0,49,39153499.12,250221,0,-24021.216,88.95,91.047
20081009,10000,0,49,38965212.34,250221,0,-191419.065,86.6,90.282
20081010,10000,0,49,37266326.31,250221,0,-1702003.242,77.7,83.48
20081014,10000,0,49,37451468.51,250221,0,182160.888,78.63,84.208
20081015,10000,0,49,36546412.62,250221,0,-908052.009,74.55,80.579
20081016,10000,0,49,35496156.14,250221,0,-1053180.189,69.85,76.37
20081017,10000,0,49,35858062.97,250221,0,359067.135,71.85,77.805
20081020,10000,0,49,36371382.45,250221,0,510450.84,74.25,79.845
20081021,10000,0,49,36085286.91,250221,0,-289005.255,70.89,78.69
20081022,10000,0,49,34775514.36,250221,0,-1312659.366,65.96,73.444
20081023,10000,0,49,34862120.44,250221,0,83824.035,66.74,73.779
20081024,10000,0,49,34087973.20,250221,0,-776936.205,63.05,70.674
20081027,10000,0,49,33729881.56,250221,0,-360818.682,63.22,69.232
20081028,10000,0,49,33511885.03,250221,0,-220694.922,62.73,68.35
20081029,10000,0,49,34728888.49,250221,0,1214322.513,68.7,73.203
20081030,10000,0,49,34727413.05,250221,0,-4253.757,65.96,73.186
20081031,10000,0,49,35096514.78,250221,0,366323.544,67.81,74.65
20081103,10000,0,49,34457005.20,250221,0,-642317.307,63.91,72.083
20081104,10000,0,49,36106716.38,250221,0,1646954.622,70.53,78.665
20081105,10000,0,49,35274617.44,250221,0,-834987.477,65.3,75.328
20081106,10000,0,49,34294321.10,250221,0,-983118.309,60.77,71.399
20081107,10000,0,49,34293061.11,250221,0,-4003.536,61.04,71.383
20081110,10000,0,49,34497482.68,250221,0,201678.126,62.41,72.189
20081112,10000,0,49,33051713.11,250221,0,-1448529.369,56.16,66.4
20081113,10000,0,49,33462467.70,250221,0,408110.451,58.24,68.031
20081114,10000,0,49,33250455.08,250221,0,-214689.618,57.04,67.173
20081117,10000,0,49,32731654.55,250221,0,-521460.564,54.95,65.089
20081118,10000,0,49,32414991.09,250221,0,-319281.996,54.39,63.813
20081119,10000,0,49,32417334.07,250221,0,-250.221,53.62,63.812
20081120,10000,0,49,31517630.53,250221,0,-902296.926,49.62,60.206
20081121,10000,0,49,31521403.04,250221,0,1251.105,49.13,60.211
20081124,10000,0,49,32546076.54,250221,0,1022151.784,53.3,64.295996
20081125,10000,0,49,31998195.03,250221,0,-550485.1991,49.77,62.096
20081126,10000,0,49,32721891.80,250221,0,721136.922,54.44,64.978
20081128,10000,0,49,32824597.95,250221,0,100088.4,54.43,65.378
20081201,10000,0,49,31878135.67,250221,0,-949088.253,49.28,61.585
20081202,10000,0,49,31321191.76,250221,0,-559494.156,46.96,59.349
20081203,10000,0,49,31440300.45,250221,0,116602.986,46.79,59.815
20081204,10000,0,49,30893830.80,250221,0,-548984.874,43.67,57.621
20081205,10000,0,49,30227461.57,250221,0,-668840.733,40.81,54.948
20081208,10000,0,49,30928997.24,250221,0,699117.474,43.71,57.742
20081209,10000,0,49,30521359.34,250221,0,-410112.219,42.07,56.103
20081210,10000,0,49,30422211.32,250221,0,-101589.726,43.52,55.697
20081211,10000,0,49,31410015.40,250221,0,985370.298,47.98,59.635
20081212,10000,0,49,31269902.23,250221,0,-142625.97,46.28,59.065
20081215,10000,0,49,31064470.17,250221,0,-207933.651,44.51,58.234
20081216,10000,0,49,30883543.34,250221,0,-183411.993,43.6,57.501
20081217,10000,0,49,30716614.40,250221,0,-169399.617,40.06,56.824
20081218,10000,0,49,30249907.36,250221,0,-469164.375,36.22,54.949
20081222,10000,0,49,29715603.30,250221,0,-536724.045,30.81,52.804
20081223,10000,0,49,29513049.55,250221,0,-204930.999,33.98,51.985
20081229,10000,0,49,29821430.88,250221,0,306020.283,40.02,53.208
20081230,10000,0,49,29927908.53,250221,0,104091.936,39.03,53.624
20090102,10000,0,49,31466159.26,250221,0,1535856.498,46.34,59.762
20090105,10000,0,49,32057196.35,250221,0,588519.792,48.81,62.114
20090106,10000,0,49,32134577.00,250221,0,74816.079,48.58,62.413
20090107,10000,0,49,31304662.50,250221,0,-832485.267,42.63,59.086
20090108,10000,0,49,31155532.95,250221,0,-151633.926,41.7,58.48
20090109,10000,0,49,31205817.60,250221,0,47792.211,40.83,58.671
20090112,10000,0,49,30869514.83,250221,0,-338799.234,37.59,57.317
20090113,10000,0,49,31124957.82,250221,0,252973.431,37.78,58.328
20090114,10000,0,49,31139458.43,250221,0,12010.608,37.28,58.376
20090115,10000,0,49,31140448.26,250221,0,-1501.326,35.4,58.37
20090116,10000,0,49,30957775.96,250221,0,-185163.54,36.51,57.63
20090120,10000,0,49,30156792.95,250221,0,-803459.631,43.48,54.419
20090121,10000,0,49,29976544.16,250221,0,-182661.33,42.25,53.689
20090122,10000,0,49,30036743.33,250221,0,57801.051,42.27,53.92
20090123,10000,0,49,30616906.56,250221,0,577760.289,45.47,56.229
20090126,10000,0,49,30398160.55,250221,0,-221195.364,45.73,55.345
20090127,10000,0,49,30030015.10,250221,0,-370577.301,41.58,53.864
20090128,10000,0,49,30323424.53,250221,0,291007.023,42.16,55.027
20090129,10000,0,49,30411175.76,250221,0,85325.361,41.44,55.368
20090130,10000,0,49,30287747.49,250221,0,-125861.163,41.68,54.865
20090202,10000,0,49,29825510.12,250221,0,-464660.397,40.08,53.008
20090203,10000,0,49,29797369.19,250221,0,-30526.962,40.78,52.886
20090204,10000,0,49,29963397.52,250221,0,163644.534,40.32,53.54
20090205,10000,0,49,30313101.34,250221,0,347306.748,41.17,54.928
20090206,10000,0,49,30452397.27,250221,0,136870.887,40.17,55.475
20090209,10000,0,49,30433064.24,250221,0,-21769.227,39.56,55.388
20090210,10000,0,49,30066923.35,250221,0,-368575.533,37.55,53.915
20090211,10000,0,49,30023288.04,250221,0,-46040.664,39.56,53.731
20090212,10000,0,49,30057968.41,250221,0,32278.509,33.98,53.86
20090213,10000,0,49,29757105.20,250221,0,-303267.852,37.51,52.648
20090217,10000,0,49,28882961.60,250221,0,-876524.163,34.93,49.145
20090218,10000,0,49,28321774.55,250221,0,-563497.692,34.62,46.893
20090219,10000,0,49,28921818.26,250221,0,597777.969,39.48,49.282
20090220,10000,0,49,28826045.37,250221,0,-98086.632,39.94,48.89
20090223,10000,0,49,28766546.87,250221,0,-61804.587,37.59,48.643
20090224,10000,0,49,29036584.66,250221,0,267736.47,38.96,49.713
20090225,10000,0,49,29272614.00,250221,0,233706.414,42.5,50.647
20090226,10000,0,49,29873734.67,250221,0,598778.853,45.22,53.04
20090227,10000,0,49,29757019.37,250221,0,-119105.196,44.76,52.564
20090302,10000,0,49,28836084.44,250221,0,-923315.49,40.15,48.874
20090303,10000,0,49,28996781.22,250221,0,158389.893,41.65,49.507
20090304,10000,0,49,29524565.06,250221,0,525464.1,45.38,51.607
20090305,10000,0,49,29374542.44,250221,0,-152384.589,43.61,50.998
20090306,10000,0,49,29633619.15,250221,0,256726.746,45.52,52.024
20090309,10000,0,49,29559422.21,250221,0,-76567.626,47.07,51.718
20090310,10000,0,49,29575549.12,250221,0,13762.155,45.71,51.773
20090311,10000,0,49,29081977.14,250221,0,-495938.022,42.33,49.791
20090312,10000,0,49,29799435.32,250221,0,715131.618,47.03,52.649
20090313,10000,0,49,29720997.89,250221,0,-80821.383,46.25,52.326
20090316,10000,0,49,29894276.51,250221,0,170900.943,47.35,53.009
20090317,10000,0,49,30452408.90,250221,0,555740.841,49.16,55.23
20090318,10000,0,49,30559187.25,250221,0,104342.157,48.14,55.647
20090319,10000,0,49,31397370.12,250221,0,835738.14,51.61,58.987
20090320,10000,0,49,31562525.56,250221,0,162643.65,51.06,59.637
20090323,10000,0,49,32124294.50,250221,0,559243.935,53,61.872
20090324,10000,0,49,32088830.85,250221,0,-38033.592,53.48,61.72
20090325,10000,0,49,31725324.63,250221,0,-366073.323,52.27,60.257
20090326,10000,0,49,32007609.74,250221,0,279747.078,54.34,61.375
20090327,10000,0,49,31724668.18,250221,0,-285502.161,52.38,60.234
20090330,10000,0,49,30984800.45,250221,0,-742405.707,48.41,57.267
20090331,10000,0,49,31095875.15,250221,0,108595.914,49.66,57.701
20090401,10000,0,49,30813110.88,250221,0,-285251.94,48.39,56.561
20090402,10000,0,49,31817210.59,250221,0,1001634.663,52.64,60.564
20090403,10000,0,49,31998663.98,250221,0,178908.015,52.51,61.279
20090406,10000,0,49,31867105.42,250221,0,-134118.456,51.05,60.743
20090407,10000,0,49,31637449.70,250221,0,-232205.088,49.15,59.815
20090408,10000,0,49,31660248.60,250221,0,20267.901,49.38,59.896
20090409,10000,0,49,32122687.61,250221,0,459906.198,52.24,61.734
20090414,10000,0,49,31703384.82,250221,0,-421872.606,49.41,60.048
20090415,10000,0,49,31507746.06,250221,0,-198175.032,49.25,59.256
20090416,10000,0,49,31617611.49,250221,0,107344.809,49.98,59.685
20090417,10000,0,49,31610882.72,250221,0,-9258.177,50.53,59.648
20090420,10000,0,49,30907538.15,250221,0,-705873.441,45.88,56.827
20090421,10000,0,49,30813675.67,250221,0,-96335.085,46.51,56.442
20090422,10000,0,49,30828902.04,250221,0,12761.271,47.35,56.493
20090423,10000,0,49,30774818.40,250221,0,-56549.946,48.62,56.267
20090424,10000,0,49,31121084.04,250221,0,343803.654,50.8,57.641
20090427,10000,0,49,30885113.12,250221,0,-238460.613,50.14,56.688
20090428,10000,0,49,30749211.71,250221,0,-138372.213,49.92,56.135
20090429,10000,0,49,30983376.29,250221,0,231704.646,50.97,57.061
20090430,10000,0,49,31040403.14,250221,0,54548.178,51.12,57.279
20090504,10000,0,49,32047023.25,250221,0,1004136.873,54.47,61.292
20090505,10000,0,49,31934485.35,250221,0,-115101.66,53.84,60.832
20090506,10000,0,49,32287849.95,250221,0,350809.842,56.34,62.234
20090507,10000,0,49,32359493.97,250221,0,69060.996,56.71,62.51
20090508,10000,0,49,32620310.81,250221,0,258228.072,58.63,63.542
20090511,10000,0,49,32596397.00,250221,0,-26523.426,58.5,63.436
20090512,10000,0,49,32655304.44,250221,0,56299.725,58.85,63.661
20090513,10000,0,49,32522046.86,250221,0,-135870.003,58.02,63.118
20090514,10000,0,49,32568437.30,250221,0,43788.675,58.62,63.293
20090515,10000,0,49,32022808.57,250221,0,-548234.211,56.34,61.102
20090518,10000,0,49,32474767.31,250221,0,449396.916,59.03,62.898
20090519,10000,0,49,32646014.24,250221,0,168648.954,59.65,63.572
20090520,10000,0,49,32922617.92,250221,0,273991.995,62.02,64.667
20090521,10000,0,49,32825663.77,250221,0,-99587.958,60.55,64.269
20090522,10000,0,49,32970915.79,250221,0,142625.97,61.71,64.839
20090526,10000,0,49,33070138.77,250221,0,96585.306,62.45,65.225
20090527,10000,0,49,33302237.04,250221,0,229452.657,63.45,66.142
20090528,10000,0,49,33752546.59,250221,0,447645.369,65.08,67.931
20090529,10000,0,49,34038997.41,250221,0,283750.614,66.31,69.065
20090601,10000,0,49,34601715.12,250221,0,559994.598,68.58,71.303
20090602,10000,0,49,34787144.59,250221,0,182661.33,68.55,72.033
20090603,10000,0,49,34423854.24,250221,0,-366073.323,66.12,70.57
20090604,10000,0,49,34939811.42,250221,0,513203.271,68.81,72.621
20090605,10000,0,49,34969380.25,250221,0,26773.647,68.44,72.728
20090608,10000,0,49,34932142.44,250221,0,-40035.36,68.09,72.568
20090609,10000,0,49,35256721.22,250221,0,321784.206,70.01,73.854
20090610,10000,0,49,35492497.51,250221,0,232955.751,71.33,74.785
20090611,10000,0,49,35797854.10,250221,0,302517.189,72.68,75.994
20090612,10000,0,49,35674106.10,250221,0,-126611.826,72.04,75.488
20090615,10000,0,49,35377195.27,250221,0,-299764.758,70.62,74.29
20090616,10000,0,49,35256416.27,250221,0,-123609.174,70.47,73.796
20090617,10000,0,49,35407868.06,250221,0,148631.274,71.03,74.39
20090618,10000,0,49,35440977.43,250221,0,30276.741,71.37,74.511
20090619,10000,0,49,35081492.70,250221,0,-362320.008,69.55,73.063
20090622,10000,0,49,34475261.30,250221,0,-609037.914,66.93,70.629
20090623,10000,0,49,34746756.68,250221,0,268737.354,68.79,71.703
20090624,10000,0,49,34677722.99,250221,0,-71813.427,68.67,71.416
20090625,10000,0,49,35028554.62,250221,0,348057.411,70.23,72.807
20090626,10000,0,49,34837185.41,250221,0,-194171.496,69.16,72.031
20090629,10000,0,49,35306384.33,250221,0,466411.944,71.49,73.895
20090630,10000,0,49,35046226.57,250221,0,-262982.271,69.89,72.844
20090701,10000,0,49,34950443.19,250221,0,-98587.074,69.31,72.45
20090702,10000,0,49,34440536.40,250221,0,-512702.829,66.73,70.401
20090706,10000,0,49,33761189.20,250221,0,-682102.446,64.05,67.675
20090707,10000,0,49,33486395.00,250221,0,-277495.089,62.93,66.566
20090708,10000,0,49,32901555.00,250221,0,-587518.908,60.14,64.218
20090709,10000,0,49,32966992.60,250221,0,62805.471,60.41,64.469
20090710,10000,0,49,32798979.24,250221,0,-170650.722,59.89,63.787
20090713,10000,0,49,32716027.57,250221,0,-85575.582,59.69,63.445
20090714,10000,0,49,32688117.89,250221,0,-30526.962,59.52,63.323
20090715,10000,0,49,33253730.19,250221,0,562997.25,61.54,65.573
20090716,10000,0,49,33478336.52,250221,0,221946.027,62.02,66.46
20090717,10000,0,49,33836829.05,250221,0,355814.262,63.56,67.882
20090720,10000,0,49,34109774.67,250221,0,270238.68,63.98,68.962
20090721,10000,0,49,34182815.56,250221,0,70312.101,64.72,69.243
20090722,10000,0,49,34292644.77,250221,0,107094.588,63.57,69.671
20090723,10000,0,49,34726769.19,250221,0,431381.004,66.11,71.395
20090724,10000,0,49,34969759.49,250221,0,240212.16,66.55,72.355
20090727,10000,0,49,34995827.62,250221,0,23270.553,68.38,72.448
20090728,10000,0,49,34766922.64,250221,0,-231704.646,67.23,71.522
20090729,10000,0,49,33988514.03,250221,0,-781189.962,63.35,68.4
20090730,10000,0,49,34697356.78,250221,0,706123.662,66.94,71.222
20090731,10000,0,49,35141772.63,250221,0,441640.065,69.45,72.987
20090803,10000,0,49,35496394.70,250221,0,351810.726,71.58,79.725
20090804,10000,0,49,35714174.25,250221,0,214939.839,71.42,80.584
20090805,10000,0,49,35907699.78,250221,0,190668.402,71.97,81.346
20090806,10000,0,49,35945353.12,250221,0,34780.719,71.94,81.485
20090807,10000,0,49,35669732.77,250221,0,-278495.973,70.93,80.372
20090810,10000,0,49,35763917.02,250221,0,91330.665,70.6,80.737
20090811,10000,0,49,35519559.78,250221,0,-247218.348,69.45,79.749
20090812,10000,0,49,35554679.86,250221,0,32278.509,70.16,79.878
20090813,10000,0,49,35640097.16,250221,0,82572.93,70.52,80.208
20090814,10000,0,49,35137001.51,250221,0,-505946.862,67.51,78.186
20090817,10000,0,49,34940386.33,250221,0,-199426.137,66.75,77.389
20090818,10000,0,49,35335277.87,250221,0,392096.307,69.19,78.956
20090819,10000,0,49,35725196.58,250221,0,387091.887,72.42,80.503
20090820,10000,0,49,35514616.08,250221,0,-213438.513,72.54,79.65
20090821,10000,0,49,35689359.08,250221,0,171901.827,73.19,80.337
20090824,10000,0,49,35755520.14,250221,0,63305.913,73.82,80.59
20090825,10000,0,49,35299225.05,250221,0,-459155.535,71.55,78.755
20090826,10000,0,49,35208966.77,250221,0,-93082.212,71.43,78.383
20090827,10000,0,49,35375428.02,250221,0,163644.534,72.49,79.037
20090828,10000,0,49,35403029.94,250221,0,24771.879,72.74,79.136
20090831,10000,0,49,34835608.52,250221,0,-570253.659,69.96,76.857
20090901,10000,0,49,34430785.36,250221,0,-407610.009,68.05,75.228
20090902,10000,0,49,34332450.54,250221,0,-101089.284,68.05,74.824
20090903,10000,0,49,34230104.31,250221,0,-105092.82,67.96,74.404
20090904,10000,0,49,34169286.59,250221,0,-63556.134,68.02,74.15
20090908,10000,0,49,34697984.67,250221,0,525964.542,71.1,76.252
20090909,10000,0,49,34787837.42,250221,0,87076.908,71.31,76.6
20090910,10000,0,49,34919734.48,250221,0,129114.036,71.94,77.116
20090911,10000,0,49,34520923.36,250221,0,-401604.705,69.29,75.511
20090914,10000,0,49,34487903.43,250221,0,-35781.603,68.86,75.368
20090915,10000,0,49,34784922.36,250221,0,294259.896,70.93,76.544
20090916,10000,0,49,35087469.91,250221,0,299764.758,72.51,77.742
20090917,10000,0,49,35246164.59,250221,0,155887.683,72.47,78.365
20090918,10000,0,49,35192934.78,250221,0,-56049.504,72.04,78.141
20090921,10000,0,49,34599723.79,250221,0,-596026.422,69.71,75.759
20090922,10000,0,49,34888244.15,250221,0,285752.382,71.55,76.901
20090923,10000,0,49,34446142.27,250221,0,-444892.938,68.97,75.123
20090924,10000,0,49,33810834.41,250221,0,-638063.55,65.79,72.573
20090925,10000,0,49,33715953.09,250221,0,-97586.19,66.02,72.183
20090928,10000,0,49,33864779.43,250221,0,146129.064,66.84,72.767
20090929,10000,0,49,33879999.66,250221,0,12511.05,66.71,72.817
20090930,10000,0,49,34605598.53,250221,0,722888.469,70.61,75.706
20091001,10000,0,49,34682432.39,250221,0,74065.416,70.82,76.002
20091002,10000,0,49,34529319.31,250221,0,-155887.683,69.95,75.379
20091005,10000,0,49,34543091.38,250221,0,11009.724,70.41,75.423
20091006,10000,0,49,34654700.96,250221,0,108846.135,70.88,75.858
20091007,10000,0,49,34465053.39,250221,0,-192419.949,69.57,75.089
20091008,10000,0,49,34999530.21,250221,0,531719.625,71.69,77.214
20091009,10000,0,49,35116931.40,250221,0,114601.218,71.77,77.672
20091013,10000,0,49,35639449.77,250221,0,519709.017,74.15,79.749
20091014,10000,0,49,35830467.11,250221,0,188166.192,75.18,80.501
20091015,10000,0,49,36320263.62,250221,0,486930.066,77.58,82.447
20091016,10000,0,49,36561129.41,250221,0,237960.171,78.53,83.398
20091019,10000,0,49,36759977.34,250221,0,195923.043,79.61,84.181
20091020,10000,0,49,36689102.95,250221,0,-73815.195,79.09,83.886
20091021,10000,0,49,37174464.16,250221,0,482426.088,81.37,85.814
20091022,10000,0,49,37231235.63,250221,0,53797.515,81.19,86.029
20091023,10000,0,49,37173910.87,250221,0,-60303.261,80.5,85.788
20091026,10000,0,49,36753761.07,250221,0,-423123.711,78.68,84.097
20091027,10000,0,49,36873554.58,250221,0,116853.207,79.55,84.564
20091028,10000,0,49,36438117.27,250221,0,-438387.192,77.46,82.812
20091029,10000,0,49,36881171.06,250221,0,440138.739,79.87,84.571
20091030,10000,0,49,36374921.82,250221,0,-509199.735,77,82.536
20091102,10000,0,49,36634308.34,250221,0,256476.525,78.13,83.561
20091103,10000,0,49,36992302.68,250221,0,355063.599,79.6,84.98
20091104,10000,0,49,37186430.91,250221,0,191168.844,80.4,85.744
20091105,10000,0,49,37027262.62,250221,0,-162143.208,79.62,85.096
20091106,10000,0,49,36585331.86,250221,0,-444892.938,77.43,83.318
20091109,10000,0,49,36981355.88,250221,0,393097.191,79.43,84.889
20091110,10000,0,49,36901491.24,250221,0,-82823.151,79.05,84.558
20091112,10000,0,49,36632453.13,250221,0,-271990.227,76.94,83.471
20091113,10000,0,49,36454724.16,250221,0,-180659.562,76.35,82.749
20091116,10000,0,49,36986107.29,250221,0,528466.752,78.9,84.861
20091117,10000,0,49,37122433.98,250221,0,133367.793,79.14,85.394
20091118,10000,0,49,37278539.02,250221,0,153135.252,79.58,86.006
20091119,10000,0,49,36895180.08,250221,0,-386341.224,77.46,84.462
20091120,10000,0,49,36780277.60,250221,0,-117854.091,76.72,83.991
20091123,10000,0,49,36804238.59,250221,0,21018.564,76.56,84.075
20091124,10000,0,49,36563467.68,250221,0,-243715.254,74.82,83.101
20091125,10000,0,49,37057076.13,250221,0,490683.381,76.91,85.062
20091127,10000,0,49,36837594.23,250221,0,-222446.469,76.91,84.173
20091130,10000,0,49,37133299.81,250221,0,292758.57,77.28,85.343
20091201,10000,0,49,37357966.28,250221,0,221695.806,78.37,86.229
20091202,10000,0,49,37098973.53,250221,0,-261981.387,78.6,85.182
20091203,10000,0,49,37196524.98,250221,0,94583.538,76.46,85.56
20091204,10000,0,49,37001575.90,250221,0,-197924.811,75.47,84.769
20091207,10000,0,49,36797102.81,250221,0,-207433.209,73.93,83.94
20091208,10000,0,49,36417959.11,250221,0,-382087.467,76.62,82.413
20091209,10000,0,49,35812335.08,250221,0,-608537.472,70.07,79.981
20091210,10000,0,49,35651055.09,250221,0,-164144.976,70.54,79.325
20091211,10000,0,49,35630636.62,250221,0,-23270.553,69.87,79.232
20091214,10000,0,49,35609966.30,250221,0,-23520.774,69.51,79.138
20091215,10000,0,49,35633583.44,250221,0,20768.343,70.69,79.221
20091216,10000,0,49,35881150.26,250221,0,244716.138,72.66,80.199
20091217,10000,0,49,35799446.06,250221,0,-84574.698,72.65,79.861
20091218,10000,0,49,35952442.61,250221,0,150132.6,73.36,80.461
20091221,10000,0,49,35781164.99,250221,0,-174153.816,72.47,79.765
20091222,10000,0,49,35812052.24,250221,0,28024.752,72.47,79.877
20091223,10000,0,49,36255806.60,250221,0,440889.402,75.74,81.639
20091228,10000,0,49,36848978.41,250221,0,590271.339,78.77,83.998
20091229,10000,0,49,36898467.43,250221,0,46541.106,76.42,84.184
20091230,10000,0,49,36963474.12,250221,0,62054.808,79.28,84.432
20100104,10000,0,49,37325998.77,250221,0,359567.577,79.36,85.869
20100105,10000,0,49,37498134.25,250221,0,169149.396,81.77,86.545
20100106,10000,0,49,37833177.37,250221,0,332043.267,83.18,87.872
20100107,10000,0,49,37727357.88,250221,0,-108846.135,82.66,87.437
20100108,10000,0,49,37794432.65,250221,0,64056.576,82.75,87.693
20100111,10000,0,49,37774435.87,250221,0,-23020.332,82.52,87.601
20100112,10000,0,49,37352082.13,250221,0,-425375.7,80.79,85.901
20100113,10000,0,49,37101596.42,250221,0,-253473.873,79.65,84.888
20100114,10000,0,49,37110319.63,250221,0,5755.083,79.39,84.911
20100115,10000,0,49,36772487.45,250221,0,-340801.002,78,83.549
20100119,10000,0,49,36890530.91,250221,0,115101.66,79.02,84.009
20100120,10000,0,49,36599222.26,250221,0,-294259.896,77.62,82.833
20100121,10000,0,49,36178776.27,250221,0,-423373.932,75.86,81.141
20100122,10000,0,49,35741031.39,250221,0,-440639.181,75.86,79.38
20100125,10000,0,49,35882763.32,250221,0,138872.655,74.54,79.935
20100126,10000,0,49,35752266.15,250221,0,-133367.793,74.71,79.402
20100127,10000,0,49,35508658.65,250221,0,-246467.685,73.67,78.417
20100128,10000,0,49,35430928.18,250221,0,-80571.162,73.64,78.095
20100129,10000,0,49,35314157.02,250221,0,-119605.638,72.89,77.617
20100201,10000,0,49,35638015.69,250221,0,321033.543,74.43,78.9
20100202,10000,0,49,36288939.12,250221,0,648072.39,77.23,81.49
20100203,10000,0,49,36296596.44,250221,0,4754.199,77.23,81.509
20100204,10000,0,49,35449499.43,250221,0,-850000.737,73.14,78.112
20100205,10000,0,49,34799759.02,250221,0,-652576.368,71.19,75.504
20100208,10000,0,49,34939413.89,250221,0,136870.887,71.19,76.051
20100209,10000,0,49,35381096.67,250221,0,438887.634,73.75,77.805
20100210,10000,0,49,35512540.76,250221,0,128613.594,74.52,78.319
20100211,10000,0,49,35731572.70,250221,0,216190.944,75.28,79.183
20100212,10000,0,49,35534254.43,250221,0,-200176.8,74.13,78.383
20100216,10000,0,49,36111104.14,250221,0,574006.974,77.01,80.677
20100217,10000,0,49,36213831.21,250221,0,99838.179,77.33,81.076
20100218,10000,0,49,36505483.35,250221,0,288755.034,79.06,82.23
20100219,10000,0,49,36580217.22,250221,0,71813.427,79.81,82.517
20100222,10000,0,49,36700997.73,250221,0,117854.091,80.16,82.988
20100223,10000,0,49,36416179.65,250221,0,-287754.15,78.86,81.838
20100224,10000,0,49,36591495.22,250221,0,172402.269,80,82.527
20100225,10000,0,49,36206579.99,250221,0,-387842.55,80,80.977
20100226,10000,0,49,36475211.22,250221,0,265734.702,79.66,82.039
20100301,10000,0,49,36330498.84,250221,0,-147630.39,78.7,81.449
20100302,10000,0,49,36509811.09,250221,0,176405.805,79.68,82.154
20100303,10000,0,49,36792979.39,250221,0,280247.52,80.87,83.274
20100304,10000,0,49,36759640.79,250221,0,-36282.045,80.21,83.129
20100305,10000,0,49,37048834.38,250221,0,286252.824,81.5,84.273
20100308,10000,0,49,37182914.09,250221,0,131115.804,81.87,84.797
20100309,10000,0,49,37091805.63,250221,0,-94083.096,81.49,84.421
20100310,10000,0,49,37152073.58,250221,0,57300.609,82.09,84.65
20100311,10000,0,49,37181318.95,250221,0,26273.205,82.11,84.755
20100312,10000,0,49,36944831.96,250221,0,-239461.497,81.24,83.798
20100315,10000,0,49,36573707.15,250221,0,-374080.395,79.8,82.303
20100316,10000,0,49,36896665.71,250221,0,320032.659,81.7,83.582
20100317,10000,0,49,37197880.87,250221,0,298263.432,82.93,84.774
20100318,10000,0,49,37151062.73,250221,0,-49793.979,82.2,84.575
20100319,10000,0,49,36795968.56,250221,0,-358066.251,80.68,83.144
20100322,10000,0,49,36908008.59,250221,0,109096.356,81.25,83.58
20100323,10000,0,49,36970764.05,250221,0,59802.819,81.56,83.819
20100324,10000,0,49,36725002.04,250221,0,-248719.674,80.36,82.825
20100325,10000,0,49,36700916.17,250221,0,-27023.868,80.03,82.717
20100326,10000,0,49,36590502.13,250221,0,-113350.113,80,82.264
20100329,10000,0,49,37001539.82,250221,0,408110.451,82.17,83.895
20100330,10000,0,49,37077814.70,250221,0,73314.753,82.37,84.188
20100331,10000,0,49,37379044.36,250221,0,298263.432,82.76,85.38
20100401,10000,0,49,37705820.66,250221,0,323785.974,84.87,86.674
20100406,10000,0,49,38326632.77,250221,0,617795.649,86.44,89.143
20100407,10000,0,49,38246125.09,250221,0,-83573.814,85.88,88.809
20100408,10000,0,49,38183626.87,250221,0,-65557.902,85.39,88.547
20100409,10000,0,49,38231721.34,250221,0,45039.78,84.92,88.727
20100412,10000,0,49,38273313.92,250221,0,38534.034,84.34,88.881
20100413,10000,0,49,38156770.14,250221,0,-119605.638,84.05,88.403
20100414,10000,0,49,38451580.37,250221,0,291757.686,85.84,89.569
20100415,10000,0,49,38663340.81,250221,0,208684.314,85.51,90.403
20100416,10000,0,49,38361164.26,250221,0,-305269.62,83.24,89.183
20100419,10000,0,49,37976640.82,250221,0,-387592.329,81.45,87.634
20100420,10000,0,49,38074762.93,250221,0,95083.98,83.45,88.014
20100421,10000,0,49,38316269.53,250221,0,238460.613,82.88,88.967
20100422,10000,0,49,38371130.58,250221,0,51795.747,83,89.174
20100423,10000,0,49,38663705.96,250221,0,289505.697,84.82,90.331
20100426,10000,0,49,38682312.76,250221,0,15513.702,84.2,90.393
20100427,10000,0,49,38466964.41,250221,0,-218442.933,82.44,89.52
20100428,10000,0,49,38504572.27,250221,0,34530.498,83.22,89.658
20100429,10000,0,49,38726095.57,250221,0,218442.933,85.17,90.531
20100430,10000,0,49,38986170.62,250221,0,256976.967,86.15,91.558
20100503,10000,0,49,39334844.72,250221,0,345555.201,86.19,92.939
20100504,10000,0,49,38596336.46,250221,0,-741655.044,82.74,89.975
20100505,10000,0,49,37937589.62,250221,0,-661834.545,79.97,87.33
20100506,10000,0,49,37236002.29,250221,0,-704622.336,77.11,84.514
20100507,10000,0,49,36908439.23,250221,0,-330541.941,75.11,83.193
20100510,10000,0,49,37357535.95,250221,0,446144.043,76.8,84.976
20100511,10000,0,49,37439344.17,250221,0,78819.615,76.37,85.291
20100512,10000,0,49,37551185.45,250221,0,108846.135,75.65,85.726
20100513,10000,0,49,37359017.17,250221,0,-195172.38,74.4,84.946
20100514,10000,0,49,36466715.15,250221,0,-895290.738,71.61,81.368
20100517,10000,0,49,35721221.48,250221,0,-748411.011,70.08,78.377
20100518,10000,0,49,35488871.43,250221,0,-235207.74,70.08,77.437
20100519,10000,0,49,35266511.64,250221,0,-225198.9,69.87,76.537
20100520,10000,0,49,34819185.39,250221,0,-450147.579,68.01,74.738
20100521,10000,0,49,34800201.69,250221,0,-21769.227,67.74,74.651
20100524,10000,0,49,34788472.89,250221,0,-14512.818,66.88,74.593
20100525,10000,0,49,34430687.51,250221,0,-360568.461,68.75,73.152
20100526,10000,0,49,34922624.02,250221,0,489182.055,71.51,75.107
20100527,10000,0,49,35666822.65,250221,0,741404.823,74.55,78.07
20100528,10000,0,49,35730479.70,250221,0,60803.703,74.55,78.313
20100601,10000,0,49,35468604.32,250221,0,-264733.818,72.58,77.255
20100602,10000,0,49,35657606.23,250221,0,186164.424,72.86,77.999
20100603,10000,0,49,36028533.93,250221,0,368075.091,74.61,79.47
20100604,10000,0,49,35284756.75,250221,0,-746659.464,71.51,76.486
20100607,10000,0,49,35229528.26,250221,0,-58051.272,71.44,76.254
20100608,10000,0,49,35214831.15,250221,0,-17515.47,71.99,76.184
20100609,10000,0,49,35678805.64,250221,0,461157.303,74.38,78.027
20100610,10000,0,49,36021460.06,250221,0,339800.118,75.48,79.385
20100611,10000,0,49,35863449.68,250221,0,-160892.103,73.78,78.742
20100614,10000,0,49,35960902.29,250221,0,94583.538,75.12,79.12
20100615,10000,0,49,36274553.65,250221,0,310774.482,76.94,80.362
20100616,10000,0,49,36521921.53,250221,0,244465.917,77.67,81.339
20100617,10000,0,49,36508829.14,250221,0,-16014.144,76.79,81.275
20100618,10000,0,49,36479471.33,250221,0,-32278.509,77.18,81.146
20100621,10000,0,49,36555454.22,250221,0,73064.532,77.82,81.438
20100622,10000,0,49,36349444.13,250221,0,-208934.535,77.21,80.603
20100623,10000,0,49,35943240.75,250221,0,-409111.335,75.48,78.968
20100624,10000,0,49,35869548.58,250221,0,-76567.626,76.16,78.662
20100625,10000,0,49,36366104.18,250221,0,493686.033,78.86,80.635
20100628,10000,0,49,36351998.44,250221,0,-17015.028,78.25,80.567
20100629,10000,0,49,35790408.02,250221,0,-564498.576,75.94,78.311
20100630,10000,0,49,35586838.93,250221,0,-206432.325,75.63,77.486
20100701,10000,0,49,35008172.27,250221,0,-581513.604,72.63,75.162
20100702,10000,0,49,34756998.61,250221,0,-253974.315,72.14,74.147
20100706,10000,0,49,34782799.50,250221,0,23020.332,71.98,74.239
20100707,10000,0,49,35270260.20,250221,0,484678.077,74.07,76.176
20100708,10000,0,49,35655419.51,250221,0,382337.688,75.44,77.704
20100709,10000,0,49,35775375.37,250221,0,117103.428,76.09,78.172
20100712,10000,0,49,35517006.68,250221,0,-261230.724,74.95,77.128
20100713,10000,0,49,35961988.55,250221,0,442140.507,77.15,78.895
20100714,10000,0,49,35957609.10,250221,0,-7256.409,77.04,78.866
20100715,10000,0,49,35856393.77,250221,0,-104091.936,76.62,78.45
20100716,10000,0,49,35747413.49,250221,0,-111848.787,76.01,78.003
20100719,10000,0,49,35809325.44,250221,0,59052.156,76.54,78.239
20100720,10000,0,49,35946558.87,250221,0,134368.677,77.44,78.776
20100721,10000,0,49,35798551.33,250221,0,-150883.263,76.28,78.173
20100722,10000,0,49,36334636.16,250221,0,533220.951,79.3,80.304
20100723,10000,0,49,36341296.25,250221,0,3753.315,78.98,80.319
20100726,10000,0,49,36347706.65,250221,0,3503.094,78.98,80.333
20100727,10000,0,49,36028580.04,250221,0,-322034.427,77.5,79.046
20100728,10000,0,49,35916110.44,250221,0,-115351.881,76.99,78.585
20100729,10000,0,49,36233011.09,250221,0,314027.355,78.36,79.84
20100730,10000,0,49,36386792.99,250221,0,150883.263,78.95,80.443
20100802,10000,0,49,36864373.17,250221,0,474669.237,81.34,86.284
20100803,10000,0,49,37143566.30,250221,0,276243.984,82.55,87.388
20100804,10000,0,49,37152042.65,250221,0,5504.862,82.47,87.41
20100805,10000,0,49,37057178.40,250221,0,-97836.411,77.5,87.019
20100806,10000,0,49,36906257.06,250221,0,-153885.915,80.7,86.404
20100809,10000,0,49,37112639.24,250221,0,203429.673,81.48,87.217
20100810,10000,0,49,36884153.82,250221,0,-231454.425,80.25,86.292
20100811,10000,0,49,36357887.14,250221,0,-529217.415,80.25,84.177
20100812,10000,0,49,35735243.27,250221,0,-625552.5,78.02,81.677
20100813,10000,0,49,35640515.90,250221,0,-97586.19,75.39,81.287
20100816,10000,0,49,35600829.57,250221,0,-42537.57,75.24,81.117
20100817,10000,0,49,35915703.22,250221,0,312025.587,75.77,82.364
20100818,10000,0,49,35880042.45,250221,0,-38534.034,75.42,82.21
20100819,10000,0,49,35567884.61,250221,0,-315028.239,74.43,80.951
20100820,10000,0,49,35337524.07,250221,0,-233205.972,73.46,80.019
20100823,10000,0,49,35219994.77,250221,0,-120356.301,73.1,79.538
20100824,10000,0,49,34984601.98,250221,0,-238210.392,71.21,78.586
20100825,10000,0,49,35200589.04,250221,0,213188.292,71.87,79.438
20100826,10000,0,49,35546458.08,250221,0,343052.991,73.36,80.809
20100827,10000,0,49,36004203.57,250221,0,454901.778,75.17,82.627
20100830,10000,0,49,36061882.31,250221,0,54798.399,74.7,82.846
20100831,10000,0,49,35645146.64,250221,0,-419620.617,71.92,81.169
20100901,10000,0,49,36001810.75,250221,0,353812.494,73.91,82.583
20100902,10000,0,49,36122544.98,250221,0,117854.091,73.91,83.054
20100903,10000,0,49,36080895.45,250221,0,-44539.338,74.6,82.876
20100907,10000,0,49,36247676.67,250221,0,163894.755,74.09,83.531
20100908,10000,0,49,36301621.57,250221,0,51045.084,74.67,83.735
20100909,10000,0,49,36129120.78,250221,0,-175404.921,74.25,83.034
20100910,10000,0,49,36158284.32,250221,0,26273.205,76.45,83.139
20100913,10000,0,49,36357850.68,250221,0,196673.706,77.19,83.925
20100914,10000,0,49,36439578.93,250221,0,78819.615,76.8,84.24
20100915,10000,0,49,36416220.89,250221,0,-26273.205,76.02,84.135
20100916,10000,0,49,36199189.93,250221,0,-219944.259,74.57,83.256
20100917,10000,0,49,36166054.04,250221,0,-36031.824,73.66,83.112
20100920,10000,0,49,36341099.37,250221,0,172152.048,74.86,83.8
20100921,10000,0,49,36123311.74,250221,0,-220694.922,73.52,82.918
20100922,10000,0,49,36009098.17,250221,0,-117103.428,72.86,82.45
20100923,10000,0,49,36000218.51,250221,0,-11760.387,73.43,82.403
20100924,10000,0,49,36166242.62,250221,0,163144.092,74.99,83.055
20100927,10000,0,49,36120092.61,250221,0,-49043.316,76.52,82.859
20100928,10000,0,49,36171024.65,250221,0,48042.432,76.18,83.051
20100929,10000,0,49,36540241.87,250221,0,366323.544,77.86,84.515
20100930,10000,0,49,36911990.85,250221,0,368825.754,79.97,85.989
20101001,10000,0,49,37237228.45,250221,0,322284.648,81.58,87.277
20101004,10000,0,49,37165641.57,250221,0,-74565.858,81.47,86.979
20101005,10000,0,49,37445109.03,250221,0,276494.205,82.82,88.084
20101006,10000,0,49,37515163.87,250221,0,67059.228,83.23,88.352
20101007,10000,0,49,37178114.74,250221,0,-340050.339,81.67,86.993
20101008,10000,0,49,37334974.91,250221,0,153885.915,82.66,87.608
20101012,10000,0,49,37239124.41,250221,0,-98837.295,81.67,87.213
20101013,10000,0,49,37453790.50,250221,0,211686.966,83.01,88.059
20101014,10000,0,49,37375214.76,250221,0,-81572.046,82.69,87.733
20101015,10000,0,49,37047913.06,250221,0,-330291.72,81.25,86.413
20101018,10000,0,49,37424957.29,250221,0,374080.395,83.08,87.908
20101019,10000,0,49,36730084.91,250221,0,-697866.369,79.49,85.119
20101020,10000,0,49,37078578.52,250221,0,345555.201,81.77,86.5
20101021,10000,0,49,36769519.22,250221,0,-312025.587,80.06,85.253
20101022,10000,0,49,36975890.46,250221,0,203429.673,81.19,86.066
20101025,10000,0,49,37134485.99,250221,0,155637.462,82,86.688
20101026,10000,0,49,37150718.46,250221,0,13261.713,82.55,86.741
20101027,10000,0,49,37098641.90,250221,0,-55048.62,81.94,86.521
20101028,10000,0,49,37160411.72,250221,0,58801.935,82.18,86.756
20101029,10000,0,49,36952698.48,250221,0,-210686.082,81.43,85.914
20101101,10000,0,49,37257671.44,250221,0,302016.747,82.95,87.121
20101102,10000,0,49,37463581.28,250221,0,202929.231,82.95,87.932
20101103,10000,0,49,37674261.80,250221,0,207683.43,84.69,88.762
20101104,10000,0,49,38011571.00,250221,0,334295.256,86.49,90.098
20101105,10000,0,49,38132716.23,250221,0,118104.312,86.49,90.57
20101108,10000,0,49,38224845.53,250221,0,89078.676,87.06,90.926
20101109,10000,0,49,38145580.81,250221,0,-82322.709,86.72,90.597
20101110,10000,0,49,38228452.95,250221,0,79820.499,87.81,90.916
20101112,10000,0,49,37657254.03,250221,0,-574257.195,84.88,88.621
20101115,10000,0,49,37597210.92,250221,0,-63055.692,84.86,88.369
20101116,10000,0,49,37139812.06,250221,0,-460406.64,82.34,86.529
20101117,10000,0,49,36758193.57,250221,0,-384589.677,80.44,84.992
20101118,10000,0,49,37026118.26,250221,0,264984.039,81.85,86.051
20101119,10000,0,49,36879948.63,250221,0,-149131.716,81.51,85.455
20101122,10000,0,49,36797073.23,250221,0,-85825.803,81.74,85.112
20101123,10000,0,49,36702180.58,250221,0,-97836.411,80.75,84.721
20101124,10000,0,49,37246595.00,250221,0,541478.244,83.26,86.885
20101126,10000,0,49,37270092.85,250221,0,20518.122,83.26,86.967
20101129,10000,0,49,37648656.18,250221,0,375581.721,83.73,88.468
20101130,10000,0,49,37322877.68,250221,0,-328790.394,84.11,87.154
20101201,10000,0,49,37799281.64,250221,0,473418.132,86.75,89.046
20101202,10000,0,49,37991472.66,250221,0,189167.076,88,89.802
20101203,10000,0,49,38065824.96,250221,0,71312.985,89.19,90.087
20101206,10000,0,49,37982794.20,250221,0,-86076.024,89.38,89.743
20101207,10000,0,49,38122203.27,250221,0,136370.445,88.69,90.288
20101208,10000,0,49,38148773.82,250221,0,23520.774,88.28,90.382
20101209,10000,0,49,38152826.61,250221,0,1000.884,88.37,90.386
20101210,10000,0,49,38020509.27,250221,0,-135369.561,87.79,89.845
20101213,10000,0,49,38207713.57,250221,0,184162.656,88.61,90.581
20101214,10000,0,49,38263817.04,250221,0,53046.852,88.28,90.793
20101215,10000,0,49,38426769.36,250221,0,159891.219,88.62,91.432
20101216,10000,0,49,38413328.92,250221,0,-16514.586,87.7,91.366
20101217,10000,0,49,38427161.49,250221,0,10759.503,88.02,91.409
20101220,10000,0,49,38646426.60,250221,0,216190.944,88.81,92.273
20101221,10000,0,49,38742350.31,250221,0,92831.991,89.22,92.644
20101222,10000,0,49,38835279.04,250221,0,89829.339,90.48,93.003
20101223,10000,0,49,39031556.47,250221,0,193170.612,92.21,93.775
20101228,10000,0,49,39085724.08,250221,0,51045.084,91.49,93.979
20101229,10000,0,49,39041058.73,250221,0,-47792.211,91.12,93.788
20101230,10000,0,49,38868026.43,250221,0,-176155.584,89.84,93.084
